unitid,institution_name,state_cd,ClassificationCode,classification_name,EFMaleCount,EFFemaleCount,EFTotalCount,sector_cd,sector_name,SPORTSCODE,PARTIC_MEN,PARTIC_WOMEN,OPEXPPERPART_MEN,OPEXPPERTEAM_MEN,OPEXPPERPART_WOMEN,OPEXPPERTEAM_WOMEN,TOTAL_OPEXP_MENWOMEN,REV_MEN,REV_WOMEN,TOTAL_REV_MENWOMEN,EXP_MEN,EXP_WOMEN,TOTAL_EXP_MENWOMEN,Sports
100654,Alabama A & M University,AL,2,NCAA Division I-FCS,1936,2856,4792,1,"Public, 4-year or above",2,16,15,17877,286039,22092,331379,617418,1196804,1015557,2212361,1196804,1015557,2212361,Basketball
100663,University of Alabama at Birmingham,AL,1,NCAA Division I-FBS,3822,6417,10239,1,"Public, 4-year or above",2,15,17,81483,1222250,32877,558908,1781158,5512768,2378869,7891637,5160789,2231178,7391967,Basketball
100724,Alabama State University,AL,2,NCAA Division I-FCS,1095,1947,3042,1,"Public, 4-year or above",2,16,16,7716,123448,6495,103914,227362,1068356,962416,2030772,1068356,962416,2030772,Basketball
100751,The University of Alabama,AL,1,NCAA Division I-FBS,12721,16165,28886,1,"Public, 4-year or above",2,17,34,174796,2971538,27705,941965,3913503,20592916,4803959,25396875,12834918,4803959,17638877,Basketball
100858,Auburn University,AL,1,NCAA Division I-FBS,11355,11591,22946,1,"Public, 4-year or above",2,18,19,141699,2550578,70111,1332116,3882694,19199986,745629,19945615,14997002,5261713,20258715,Basketball
101480,Jacksonville State University,AL,2,NCAA Division I-FCS,2529,3784,6313,1,"Public, 4-year or above",2,15,15,33313,499699,18933,283998,783697,1967554,1289566,3257120,1967554,1289566,3257120,Basketball
101879,University of North Alabama,AL,2,NCAA Division I-FCS,1676,2926,4602,1,"Public, 4-year or above",2,15,13,34960,524396,19566,254353,778749,1571490,1171608,2743098,1571490,1171608,2743098,Basketball
102049,Samford University,AL,2,NCAA Division I-FCS,1162,2447,3609,2,"Private nonprofit, 4-year or above",2,22,14,16309,358787,10655,149170,507957,2367772,1391188,3758960,2482928,1427741,3910669,Basketball
102094,University of South Alabama,AL,1,NCAA Division I-FBS,2676,4371,7047,1,"Public, 4-year or above",2,13,15,61836,803868,14472,217080,1020948,2691430,1662812,4354242,2691430,1662812,4354242,Basketball
102368,Troy University,AL,1,NCAA Division I-FBS,2498,4571,7069,1,"Public, 4-year or above",2,18,16,18966,341391,14804,236869,578260,1864926,1580607,3445533,1773986,1522070,3296056,Basketball
104151,Arizona State University Campus Immersion,AZ,1,NCAA Division I-FBS,30113,29652,59765,1,"Public, 4-year or above",2,19,31,88047,1672901,24561,761389,2434290,10057620,4391507,14449127,9009832,4391507,13401339,Basketball
104179,University of Arizona,AZ,1,NCAA Division I-FBS,13006,17130,30136,1,"Public, 4-year or above",2,19,12,252012,4788227,111753,1341039,6129266,26326675,2016027,28342702,15934003,5882695,21816698,Basketball
104717,Grand Canyon University,AZ,3,NCAA Division I without football,9548,14353,23901,3,"Private for-profit, 4-year or above",2,15,15,96108,1441625,67052,1005777,2447402,7668046,2509736,10177782,7668046,2509736,10177782,Basketball
105330,Northern Arizona University,AZ,2,NCAA Division I-FCS,7503,12507,20010,1,"Public, 4-year or above",2,17,12,27155,461641,49702,596423,1058064,1706778,1636207,3342985,1706778,1636207,3342985,Basketball
106245,University of Arkansas at Little Rock,AR,3,NCAA Division I without football,1180,1697,2877,1,"Public, 4-year or above",2,15,12,34842,522627,23126,277510,800137,2297311,1639191,3936502,2297311,1639191,3936502,Basketball
106397,University of Arkansas,AR,1,NCAA Division I-FBS,10440,12955,23395,1,"Public, 4-year or above",2,15,14,252749,3791240,130423,1825926,5617166,19431939,383299,19815238,13804715,5596941,19401656,Basketball
106412,University of Arkansas at Pine Bluff,AR,2,NCAA Division I-FCS,807,1033,1840,1,"Public, 4-year or above",2,14,17,20116,281626,16091,273551,555177,707328,653611,1360939,707328,653611,1360939,Basketball
106458,Arkansas State University,AR,1,NCAA Division I-FBS,2103,2992,5095,1,"Public, 4-year or above",2,16,14,40349,645589,30648,429067,1074656,1966573,1373032,3339605,1966573,1373032,3339605,Basketball
106704,University of Central Arkansas,AR,2,NCAA Division I-FCS,2538,4082,6620,1,"Public, 4-year or above",2,17,13,24655,419134,16536,214969,634103,1339958,1000428,2340386,1339958,1000428,2340386,Basketball
110361,California Baptist University,CA,3,NCAA Division I without football,2674,4554,7228,2,"Private nonprofit, 4-year or above",2,17,14,34909,593459,28939,405144,998603,4308059,2403510,6711569,3904277,2327263,6231540,Basketball
110422,California Polytechnic State University-San Luis Obispo,CA,2,NCAA Division I-FCS,10121,9823,19944,1,"Public, 4-year or above",2,17,20,26543,451230,15724,314487,765717,2299883,1963160,4263043,2299883,1963160,4263043,Basketball
110486,California State University-Bakersfield,CA,3,NCAA Division I without football,2228,4393,6621,1,"Public, 4-year or above",2,13,14,42020,546256,20921,292894,839150,2835333,1614721,4450054,2427949,1512982,3940931,Basketball
110556,California State University-Fresno,CA,1,NCAA Division I-FBS,7006,10551,17557,1,"Public, 4-year or above",2,15,25,53341,800119,21203,530084,1330203,3818506,2606192,6424698,3818506,2606192,6424698,Basketball
110565,California State University-Fullerton,CA,3,NCAA Division I without football,11543,16240,27783,1,"Public, 4-year or above",2,16,14,26571,425142,19752,276527,701669,2113578,1341226,3454804,2113578,1341226,3454804,Basketball
110583,California State University-Long Beach,CA,3,NCAA Division I without football,11277,16322,27599,1,"Public, 4-year or above",2,15,16,31753,476294,30579,489256,965550,2507334,2091552,4598886,2507334,2091552,4598886,Basketball
110608,California State University-Northridge,CA,3,NCAA Division I without football,11699,14437,26136,1,"Public, 4-year or above",2,19,18,27623,524843,18820,338757,863600,2453913,1636734,4090647,2613273,1687859,4301132,Basketball
110617,California State University-Sacramento,CA,2,NCAA Division I-FCS,9622,12935,22557,1,"Public, 4-year or above",2,14,14,33322,466501,27816,389425,855926,2359870,1843195,4203065,2359870,1843195,4203065,Basketball
110635,University of California-Berkeley,CA,1,NCAA Division I-FBS,13635,17185,30820,1,"Public, 4-year or above",2,15,30,130023,1950350,46895,1406853,3357203,9070947,5035689,14106636,9071947,5035689,14107636,Basketball
110644,University of California-Davis,CA,2,NCAA Division I-FCS,12305,18349,30654,1,"Public, 4-year or above",2,15,24,30982,464728,14249,341965,806693,2823059,2113297,4936356,2823059,2113297,4936356,Basketball
110653,University of California-Irvine,CA,3,NCAA Division I without football,12209,15712,27921,1,"Public, 4-year or above",2,16,14,51454,823262,31865,446111,1269373,3536202,2201760,5737962,3536202,2201760,5737962,Basketball
110662,University of California-Los Angeles,CA,1,NCAA Division I-FBS,12533,19230,31763,1,"Public, 4-year or above",2,16,25,163400,2614403,61280,1531988,4146391,14666248,7016096,21682344,13825844,7016096,20841940,Basketball
110671,University of California-Riverside,CA,3,NCAA Division I without football,10531,11423,21954,1,"Public, 4-year or above",2,15,15,38823,582342,23796,356946,939288,2640169,2001237,4641406,2371151,2001237,4372388,Basketball
110705,University of California-Santa Barbara,CA,3,NCAA Division I without football,10006,12787,22793,1,"Public, 4-year or above",2,17,14,32863,558675,26558,371811,930486,4045142,2110532,6155674,4045142,2110532,6155674,Basketball
117946,Loyola Marymount University,CA,3,NCAA Division I without football,3267,3725,6992,2,"Private nonprofit, 4-year or above",2,16,14,135742,2171864,58769,822770,2994634,7269326,3686168,10955494,7269326,3686168,10955494,Basketball
120883,University of the Pacific,CA,3,NCAA Division I without football,1463,1711,3174,2,"Private nonprofit, 4-year or above",2,14,14,42187,590620,30480,426726,1017346,3399931,2224707,5624638,3399931,2224707,5624638,Basketball
121150,Pepperdine University,CA,3,NCAA Division I without football,1435,2014,3449,2,"Private nonprofit, 4-year or above",2,15,21,47953,719289,19633,412292,1131581,4407186,2783072,7190258,4407186,2783072,7190258,Basketball
122409,San Diego State University,CA,1,NCAA Division I-FBS,11992,16456,28448,1,"Public, 4-year or above",2,17,23,255074,4336256,61703,1419160,5755416,14133695,2254235,16387930,9114263,3119460,12233723,Basketball
122436,University of San Diego,CA,2,NCAA Division I-FCS,2371,3086,5457,2,"Private nonprofit, 4-year or above",2,18,17,44525,801448,30232,513939,1315387,5272864,2672491,7945355,5272864,2672491,7945355,Basketball
122612,University of San Francisco,CA,3,NCAA Division I without football,2040,3753,5793,2,"Private nonprofit, 4-year or above",2,15,15,85675,1285131,54144,812164,2097295,6010817,3309971,9320788,6010817,3309971,9320788,Basketball
122755,San Jose State University,CA,1,NCAA Division I-FBS,11175,10351,21526,1,"Public, 4-year or above",2,13,15,61800,803406,25224,378365,1181771,3254424,2152244,5406668,3254424,2152244,5406668,Basketball
122931,Santa Clara University,CA,3,NCAA Division I without football,3079,2910,5989,2,"Private nonprofit, 4-year or above",2,15,14,119413,1791192,42161,590247,2381439,5726589,2826415,8553004,5726589,2826415,8553004,Basketball
123554,Saint Mary's College of California,CA,3,NCAA Division I without football,839,1073,1912,2,"Private nonprofit, 4-year or above",2,14,17,134864,1888099,28748,488717,2376816,6444755,2307746,8752501,6444755,2307746,8752501,Basketball
123961,University of Southern California,CA,1,NCAA Division I-FBS,9562,10495,20057,2,"Private nonprofit, 4-year or above",2,15,14,113773,1706593,75808,1061305,2767898,10943295,6096280,17039575,10943295,6096280,17039575,Basketball
126614,University of Colorado Boulder,CO,1,NCAA Division I-FBS,15337,13317,28654,1,"Public, 4-year or above",2,18,28,78883,1419889,48982,1371491,2791380,9459880,1144678,10604558,8200758,5034934,13235692,Basketball
126818,Colorado State University-Fort Collins,CO,1,NCAA Division I-FBS,10010,12193,22203,1,"Public, 4-year or above",2,16,16,87013,1392211,62776,1004414,2396625,5948014,3375789,9323803,5948014,3375789,9323803,Basketball
127060,University of Denver,CO,3,NCAA Division I without football,2506,3154,5660,2,"Private nonprofit, 4-year or above",2,16,14,36685,586960,28000,391993,978953,2845383,2311301,5156684,2845383,2311301,5156684,Basketball
127741,University of Northern Colorado,CO,2,NCAA Division I-FCS,1802,3563,5365,1,"Public, 4-year or above",2,15,22,30953,464298,18177,399896,864194,1797779,1558657,3356436,1797779,1558657,3356436,Basketball
128771,Central Connecticut State University,CT,2,NCAA Division I-FCS,3338,2738,6076,1,"Public, 4-year or above",2,15,14,11141,167113,8325,116554,283667,1184265,1109786,2294051,1184265,1109786,2294051,Basketball
129020,University of Connecticut,CT,1,NCAA Division I-FBS,8591,9728,18319,1,"Public, 4-year or above",2,16,12,286210,4579358,245513,2946157,7525515,13100942,9977779,23078721,13100942,9977779,23078721,Basketball
129242,Fairfield University,CT,3,NCAA Division I without football,1954,2701,4655,2,"Private nonprofit, 4-year or above",2,15,13,63138,947063,46434,603641,1550704,3348747,2724331,6073078,3348747,2724331,6073078,Basketball
130226,Quinnipiac University,CT,3,NCAA Division I without football,2240,3606,5846,2,"Private nonprofit, 4-year or above",2,14,15,8211,114958,6499,97489,212447,2837501,2417250,5254751,2837501,2417250,5254751,Basketball
130253,Sacred Heart University,CT,2,NCAA Division I-FCS,2091,4186,6277,2,"Private nonprofit, 4-year or above",2,14,16,20409,285726,24405,390481,676207,1749823,1877015,3626838,1749823,1877015,3626838,Basketball
130794,Yale University,CT,2,NCAA Division I-FCS,3218,3370,6588,2,"Private nonprofit, 4-year or above",2,17,14,24468,415963,24689,345649,761612,2254779,1298673,3553452,1733986,1110798,2844784,Basketball
130934,Delaware State University,DE,2,NCAA Division I-FCS,1332,2674,4006,1,"Public, 4-year or above",2,15,16,11492,172383,8097,129556,301939,1126714,661736,1788450,1126714,661736,1788450,Basketball
130943,University of Delaware,DE,2,NCAA Division I-FCS,7375,10647,18022,1,"Public, 4-year or above",2,17,25,36766,625017,15266,381641,1006658,3241540,2537531,5779071,3241540,2537531,5779071,Basketball
131159,American University,DC,3,NCAA Division I without football,2633,4778,7411,2,"Private nonprofit, 4-year or above",2,17,13,20721,352255,22218,288828,641083,2656602,2000835,4657437,2656602,2000835,4657437,Basketball
131469,George Washington University,DC,3,NCAA Division I without football,3781,6444,10225,2,"Private nonprofit, 4-year or above",2,14,21,68077,953081,34635,727336,1680417,4916917,3627748,8544665,4916917,3627748,8544665,Basketball
131496,Georgetown University,DC,2,NCAA Division I-FCS,2995,4153,7148,2,"Private nonprofit, 4-year or above",2,14,17,293343,4106804,51772,880116,4986920,34422346,4614226,39036572,34324430,3505311,37829741,Basketball
131520,Howard University,DC,2,NCAA Division I-FCS,2449,6570,9019,2,"Private nonprofit, 4-year or above",2,18,16,10564,190157,7193,115088,305245,1440644,1397291,2837935,1440644,1397291,2837935,Basketball
132602,Bethune-Cookman University,FL,2,NCAA Division I-FCS,936,1591,2527,2,"Private nonprofit, 4-year or above",2,17,14,24441,415497,18650,261097,676594,1385117,1027378,2412495,1385117,1027378,2412495,Basketball
132903,University of Central Florida,FL,1,NCAA Division I-FBS,18195,22324,40519,1,"Public, 4-year or above",2,16,16,89945,1439117,55498,887973,2327090,6034003,3787635,9821638,6034003,3787635,9821638,Basketball
133650,Florida Agricultural and Mechanical University,FL,2,NCAA Division I-FCS,2235,4377,6612,1,"Public, 4-year or above",2,20,13,20414,408270,20676,268789,677059,1304563,1235436,2539999,1304563,1235436,2539999,Basketball
133669,Florida Atlantic University,FL,1,NCAA Division I-FBS,6532,9080,15612,1,"Public, 4-year or above",2,15,20,67694,1015404,29461,589215,1604619,4092094,2125857,6217951,4092094,2125857,6217951,Basketball
133951,Florida International University,FL,1,NCAA Division I-FBS,10667,14555,25222,1,"Public, 4-year or above",2,15,12,36503,547547,32223,386681,934228,2714624,1475155,4189779,2714624,1475155,4189779,Basketball
134097,Florida State University,FL,1,NCAA Division I-FBS,12447,17028,29475,1,"Public, 4-year or above",2,20,10,142037,2840733,215445,2154452,4995185,19065253,5707039,24772292,13990511,5707039,19697550,Basketball
134130,University of Florida,FL,1,NCAA Division I-FBS,13165,17525,30690,1,"Public, 4-year or above",2,15,15,143921,2158820,113000,1695003,3853823,12795299,111571,12906870,8432245,5077821,13510066,Basketball
134945,Jacksonville University,FL,3,NCAA Division I without football,907,1428,2335,2,"Private nonprofit, 4-year or above",2,14,15,37796,529138,18377,275655,804793,2324443,1701606,4026049,2324443,1701606,4026049,Basketball
135726,University of Miami,FL,1,NCAA Division I-FBS,5528,6312,11840,2,"Private nonprofit, 4-year or above",2,15,52,138393,2075902,30763,1599657,3675559,13991976,7912829,21904805,13991976,7912829,21904805,Basketball
136172,University of North Florida,FL,3,NCAA Division I without football,4522,6228,10750,1,"Public, 4-year or above",2,13,11,37139,482807,23258,255839,738646,1836719,1234109,3070828,1836719,1234109,3070828,Basketball
137351,University of South Florida,FL,1,NCAA Division I-FBS,12671,17010,29681,1,"Public, 4-year or above",2,15,14,106702,1600533,106640,1492957,3093490,6301950,4301377,10603327,6301950,4301377,10603327,Basketball
137546,Stetson University,FL,2,NCAA Division I-FCS,1058,1412,2470,2,"Private nonprofit, 4-year or above",2,14,12,27153,380137,31943,383312,763449,2214190,2118196,4332386,2214190,2118196,4332386,Basketball
139755,Georgia Institute of Technology-Main Campus,GA,1,NCAA Division I-FBS,9684,6426,16110,1,"Public, 4-year or above",2,16,30,167129,2674065,55417,1662499,4336564,13357762,813281,14171043,8862986,5309473,14172459,Basketball
139931,Georgia Southern University,GA,1,NCAA Division I-FBS,7602,10205,17807,1,"Public, 4-year or above",2,15,16,36751,551263,22862,365793,917056,1961403,1388654,3350057,1961403,1388654,3350057,Basketball
139940,Georgia State University,GA,1,NCAA Division I-FBS,8690,12854,21544,1,"Public, 4-year or above",2,16,15,48276,772420,34564,518459,1290879,2781625,1937829,4719454,2781625,1937829,4719454,Basketball
139959,University of Georgia,GA,1,NCAA Division I-FBS,11938,16820,28758,1,"Public, 4-year or above",2,14,16,122279,1711906,70271,1124340,2836246,13116828,1524813,14641641,10306498,6066450,16372948,Basketball
140447,Mercer University,GA,2,NCAA Division I-FCS,1516,2542,4058,2,"Private nonprofit, 4-year or above",2,17,14,20118,342011,23663,331282,673293,2162026,2046558,4208584,2162026,2046558,4208584,Basketball
141574,University of Hawaii at Manoa,HI,1,NCAA Division I-FBS,4421,6908,11329,1,"Public, 4-year or above",2,15,16,44011,660163,40488,647808,1307971,2339181,1286866,3626047,3079142,2414310,5493452,Basketball
142115,Boise State University,ID,1,NCAA Division I-FBS,5808,7594,13402,1,"Public, 4-year or above",2,16,24,64381,1030089,25754,618093,1648182,4719560,2786092,7505652,4823977,2786092,7610069,Basketball
142276,Idaho State University,ID,2,NCAA Division I-FCS,2125,3208,5333,1,"Public, 4-year or above",2,17,29,22826,388049,11106,322061,710110,1335708,1480647,2816355,1335708,1480647,2816355,Basketball
142285,University of Idaho,ID,2,NCAA Division I-FCS,3309,3321,6630,1,"Public, 4-year or above",2,15,13,37980,569706,42307,549995,1119701,1688044,1530835,3218879,1688044,1530835,3218879,Basketball
143358,Bradley University,IL,3,NCAA Division I without football,1963,2063,4026,2,"Private nonprofit, 4-year or above",2,16,16,44564,713027,20856,333695,1046722,4499983,1626219,6126202,3946239,1680166,5626405,Basketball
144005,Chicago State University,IL,3,NCAA Division I without football,331,604,935,1,"Public, 4-year or above",2,17,15,33465,568897,16958,254369,823266,1294165,908767,2202932,1294165,908767,2202932,Basketball
144740,DePaul University,IL,3,NCAA Division I without football,5733,7126,12859,2,"Private nonprofit, 4-year or above",2,15,15,142984,2144766,72961,1094421,3239187,10540660,4411467,14952127,9404886,4411467,13816353,Basketball
144892,Eastern Illinois University,IL,2,NCAA Division I-FCS,1590,2421,4011,1,"Public, 4-year or above",2,14,15,17869,250161,12058,180863,431024,1215134,994835,2209969,1215134,994835,2209969,Basketball
145600,University of Illinois Chicago,IL,3,NCAA Division I without football,9110,10455,19565,1,"Public, 4-year or above",2,13,15,51806,673475,25101,376522,1049997,2832829,1927618,4760447,2832829,1927618,4760447,Basketball
145637,University of Illinois Urbana-Champaign,IL,1,NCAA Division I-FBS,17641,15632,33273,1,"Public, 4-year or above",2,13,13,204484,2658288,119289,1550756,4209044,28194287,1642652,29836939,14212102,6060973,20273075,Basketball
145813,Illinois State University,IL,2,NCAA Division I-FCS,7298,9655,16953,1,"Public, 4-year or above",2,15,15,44296,664436,27651,414761,1079197,2754797,1793105,4547902,2754797,1793105,4547902,Basketball
146719,Loyola University Chicago,IL,3,NCAA Division I without football,3447,7698,11145,2,"Private nonprofit, 4-year or above",2,16,13,91252,1460026,57852,752070,2212096,5274226,2723424,7997650,5274226,2723424,7997650,Basketball
147703,Northern Illinois University,IL,1,NCAA Division I-FBS,4647,5278,9925,1,"Public, 4-year or above",2,14,15,25521,357300,26225,393371,750671,1249270,1465901,2715171,1249270,1465901,2715171,Basketball
147767,Northwestern University,IL,1,NCAA Division I-FBS,3978,4610,8588,2,"Private nonprofit, 4-year or above",2,13,15,157102,2042320,96187,1442798,3485118,14053987,1656934,15710921,12431297,5854676,18285973,Basketball
149222,Southern Illinois University-Carbondale,IL,2,NCAA Division I-FCS,3248,3448,6696,1,"Public, 4-year or above",2,15,14,32883,493239,21156,296183,789422,2573107,1444648,4017755,2573107,1444648,4017755,Basketball
149231,Southern Illinois University-Edwardsville,IL,3,NCAA Division I without football,3301,4392,7693,1,"Public, 4-year or above",2,15,16,19752,296287,30006,480093,776380,1415268,1527375,2942643,1415268,1527375,2942643,Basketball
149772,Western Illinois University,IL,2,NCAA Division I-FCS,1910,2559,4469,1,"Public, 4-year or above",2,16,13,11420,182722,11650,151450,334172,1086650,880709,1967359,1086650,880709,1967359,Basketball
150136,Ball State University,IN,1,NCAA Division I-FBS,4909,7711,12620,1,"Public, 4-year or above",2,14,12,36991,517872,37247,446965,964837,2679287,1859524,4538811,2679287,1859524,4538811,Basketball
150163,Butler University,IN,2,NCAA Division I-FCS,1726,2522,4248,2,"Private nonprofit, 4-year or above",2,13,25,138273,1797554,17866,446653,2244207,11350436,2548768,13899204,8323023,2501877,10824900,Basketball
150534,University of Evansville,IN,3,NCAA Division I without football,546,874,1420,2,"Private nonprofit, 4-year or above",2,15,16,41113,616688,14322,229152,845840,2952074,1640090,4592164,2952074,1640090,4592164,Basketball
151102,Purdue University Fort Wayne,IN,3,NCAA Division I without football,2314,2203,4517,1,"Public, 4-year or above",2,15,20,35432,531478,14595,291890,823368,2372606,1400912,3773518,2372607,1400912,3773519,Basketball
151111,Indiana University-Purdue University-Indianapolis,IN,3,NCAA Division I without football,5937,8987,14924,1,"Public, 4-year or above",2,20,13,19913,398269,14678,190808,589077,2493470,1459211,3952681,2493470,1459211,3952681,Basketball
151306,University of Southern Indiana,IN,3,NCAA Division I without football,1771,3063,4834,1,"Public, 4-year or above",2,15,15,17183,257746,9511,142660,400406,1253115,888948,2142063,1253115,888949,2142064,Basketball
151324,Indiana State University,IN,2,NCAA Division I-FCS,2479,3259,5738,1,"Public, 4-year or above",2,16,14,46616,745862,21703,303844,1049706,2545679,1488287,4033966,2545679,1488287,4033966,Basketball
151351,Indiana University-Bloomington,IN,1,NCAA Division I-FBS,17336,17201,34537,1,"Public, 4-year or above",2,17,31,303700,5162897,82135,2546194,7709091,26940285,7265369,34205654,16804251,7265369,24069620,Basketball
152080,University of Notre Dame,IN,1,NCAA Division I-FBS,4568,4331,8899,2,"Private nonprofit, 4-year or above",2,13,12,233879,3040427,209519,2514226,5554653,15058993,6303431,21362424,15058993,6303431,21362424,Basketball
152600,Valparaiso University,IN,2,NCAA Division I-FCS,986,1315,2301,2,"Private nonprofit, 4-year or above",2,16,12,11452,183224,7772,93265,276489,3940291,1365776,5306067,4011597,1369962,5381559,Basketball
153269,Drake University,IA,2,NCAA Division I-FCS,1090,1649,2739,2,"Private nonprofit, 4-year or above",2,14,27,69714,975992,25116,678119,1654111,3708087,2247072,5955159,3708087,2247072,5955159,Basketball
153603,Iowa State University,IA,1,NCAA Division I-FBS,13263,10668,23931,1,"Public, 4-year or above",2,13,15,157278,2044617,121054,1815815,3860432,16120049,881254,17001303,8326965,5271866,13598831,Basketball
153658,University of Iowa,IA,1,NCAA Division I-FBS,8804,11332,20136,1,"Public, 4-year or above",2,15,26,158038,2370577,120607,3135780,5506357,14684165,3804579,18488744,10393230,8211454,18604684,Basketball
154095,University of Northern Iowa,IA,2,NCAA Division I-FCS,2635,4328,6963,1,"Public, 4-year or above",2,15,31,45797,686950,14431,447367,1134317,3311458,1466335,4777793,3296659,1466335,4762994,Basketball
155317,University of Kansas,KS,1,NCAA Division I-FBS,7796,8933,16729,1,"Public, 4-year or above",2,17,17,202891,3449140,105522,1793866,5243006,18347052,354330,18701382,15273973,4850331,20124304,Basketball
155399,Kansas State University,KS,1,NCAA Division I-FBS,6790,6629,13419,1,"Public, 4-year or above",2,15,35,174630,2619454,45605,1596170,4215624,11461173,377677,11838850,9310785,4499636,13810421,Basketball
156286,Bellarmine University,KY,3,NCAA Division I without football,840,1369,2209,2,"Private nonprofit, 4-year or above",2,17,17,38712,658107,21659,368210,1026317,2567126,1494092,4061218,2567126,1494092,4061218,Basketball
156620,Eastern Kentucky University,KY,2,NCAA Division I-FCS,3784,5726,9510,1,"Public, 4-year or above",2,16,15,34100,545607,14108,211621,757228,2201105,1256549,3457654,2201105,1256549,3457654,Basketball
157085,University of Kentucky,KY,1,NCAA Division I-FBS,8721,12023,20744,1,"Public, 4-year or above",2,15,15,292711,4390660,98179,1472686,5863346,24152043,5621816,29773859,24152043,5621816,29773859,Basketball
157289,University of Louisville,KY,1,NCAA Division I-FBS,4963,6303,11266,1,"Public, 4-year or above",2,15,14,178728,2680915,149062,2086871,4767786,38452776,2155945,40608721,19081734,6199356,25281090,Basketball
157386,Morehead State University,KY,2,NCAA Division I-FCS,1692,2639,4331,1,"Public, 4-year or above",2,16,16,22856,365700,14323,229162,594862,1545120,1124472,2669592,1545120,1124472,2669592,Basketball
157401,Murray State University,KY,2,NCAA Division I-FCS,2233,3565,5798,1,"Public, 4-year or above",2,14,16,42960,601442,23275,372400,973842,4306180,1527348,5833528,2823064,1348545,4171609,Basketball
157447,Northern Kentucky University,KY,3,NCAA Division I without football,2958,4162,7120,1,"Public, 4-year or above",2,16,16,40732,651710,22614,361827,1013537,2537322,1493480,4030802,2537322,1493480,4030802,Basketball
157951,Western Kentucky University,KY,1,NCAA Division I-FBS,4199,6756,10955,1,"Public, 4-year or above",2,15,14,61691,925367,29752,416530,1341897,2911549,1461500,4373049,2911549,1461500,4373049,Basketball
159009,Grambling State University,LA,2,NCAA Division I-FCS,1359,2329,3688,1,"Public, 4-year or above",2,15,15,27343,410146,23174,347614,757760,1040702,940403,1981105,1040702,940402,1981104,Basketball
159391,Louisiana State University and Agricultural & Mechanical College,LA,1,NCAA Division I-FBS,11846,14550,26396,1,"Public, 4-year or above",2,17,15,105755,1797829,119698,1795469,3593298,12031865,2486618,14518483,10687801,10251412,20939213,Basketball
159647,Louisiana Tech University,LA,1,NCAA Division I-FBS,3984,2965,6949,1,"Public, 4-year or above",2,14,15,48643,681004,31513,472691,1153695,2608492,1941602,4550094,2608492,1941602,4550094,Basketball
159717,McNeese State University,LA,2,NCAA Division I-FCS,1743,2627,4370,1,"Public, 4-year or above",2,17,15,3293,55973,2245,33675,89648,1610650,1065942,2676592,1716406,961064,2677470,Basketball
159939,University of New Orleans,LA,3,NCAA Division I without football,1974,2001,3975,1,"Public, 4-year or above",2,16,15,20290,324645,15137,227050,551695,2256639,1835894,4092533,1549938,1082432,2632370,Basketball
159966,Nicholls State University,LA,2,NCAA Division I-FCS,1553,2681,4234,1,"Public, 4-year or above",2,16,12,22099,353590,12562,150749,504339,1115701,749177,1864878,1115701,749177,1864878,Basketball
159993,University of Louisiana at Monroe,LA,1,NCAA Division I-FBS,1475,2552,4027,1,"Public, 4-year or above",2,14,17,23731,332228,19184,326129,658357,1419823,1554984,2974807,1419823,1554984,2974807,Basketball
160038,Northwestern State University of Louisiana,LA,2,NCAA Division I-FCS,1447,3122,4569,1,"Public, 4-year or above",2,16,16,23656,378501,11909,190543,569044,1628739,887806,2516545,1099782,803684,1903466,Basketball
160612,Southeastern Louisiana University,LA,2,NCAA Division I-FCS,2911,4796,7707,1,"Public, 4-year or above",2,15,15,18948,284226,17270,259044,543270,1142611,1008234,2150845,1142611,1008234,2150845,Basketball
160621,Southern University and A & M College,LA,2,NCAA Division I-FCS,1679,3396,5075,1,"Public, 4-year or above",2,14,17,28239,395352,21455,364729,760081,688583,491983,1180566,1023075,935927,1959002,Basketball
160658,University of Louisiana at Lafayette,LA,1,NCAA Division I-FBS,4469,6077,10546,1,"Public, 4-year or above",2,16,17,59097,945545,28576,485799,1431344,3308048,1968100,5276148,3308048,1968100,5276148,Basketball
160755,Tulane University of Louisiana,LA,1,NCAA Division I-FBS,3104,4977,8081,2,"Private nonprofit, 4-year or above",2,16,13,89582,1433311,57561,748295,2181606,5390610,1865536,7256146,5949218,4111350,10060568,Basketball
161253,University of Maine,ME,2,NCAA Division I-FCS,3885,3716,7601,1,"Public, 4-year or above",2,18,15,22397,403139,22170,332556,735695,2049546,1580122,3629668,2049546,1580122,3629668,Basketball
162283,Coppin State University,MD,3,NCAA Division I without football,326,1009,1335,1,"Public, 4-year or above",2,14,13,10049,140687,6816,88607,229294,965208,755131,1720339,713728,425262,1138990,Basketball
163046,Loyola University Maryland,MD,3,NCAA Division I without football,1768,2177,3945,2,"Private nonprofit, 4-year or above",2,18,15,23924,430624,16542,248133,678757,1974951,1685475,3660426,1974951,1685475,3660426,Basketball
163268,University of Maryland-Baltimore County,MD,3,NCAA Division I without football,4863,4206,9069,1,"Public, 4-year or above",2,17,14,29900,508308,27009,378132,886440,2423647,1917120,4340767,2423647,1917120,4340767,Basketball
163286,University of Maryland-College Park,MD,1,NCAA Division I-FBS,14029,13883,27912,1,"Public, 4-year or above",2,15,13,175000,2625004,153495,1995430,4620434,15049597,1053746,16103343,12021302,7476313,19497615,Basketball
163338,University of Maryland Eastern Shore,MD,3,NCAA Division I without football,802,947,1749,1,"Public, 4-year or above",2,13,15,20873,271348,21847,327700,599048,1289145,1145581,2434726,1127862,1176332,2304194,Basketball
163453,Morgan State University,MD,2,NCAA Division I-FCS,2608,4398,7006,1,"Public, 4-year or above",2,16,15,41458,663326,29764,446454,1109780,2426960,1564017,3990977,1982520,1514467,3496987,Basketball
163462,Mount St. Mary's University,MD,3,NCAA Division I without football,825,916,1741,2,"Private nonprofit, 4-year or above",2,13,14,32534,422941,18238,255338,678279,1960163,1195130,3155293,1960163,1195130,3155293,Basketball
164076,Towson University,MD,2,NCAA Division I-FCS,6047,8722,14769,1,"Public, 4-year or above",2,16,13,36748,587964,36305,471966,1059930,2478685,1869415,4348100,2478685,1869415,4348100,Basketball
164924,Boston College,MA,1,NCAA Division I-FBS,4508,5085,9593,2,"Private nonprofit, 4-year or above",2,16,13,175316,2805057,125555,1632210,4437267,10074076,979620,11053696,10158576,5229251,15387827,Basketball
164988,Boston University,MA,3,NCAA Division I without football,7245,10170,17415,2,"Private nonprofit, 4-year or above",2,17,12,26626,452649,23221,278652,731301,3017607,2034385,5051992,3017607,2034385,5051992,Basketball
166027,Harvard University,MA,2,NCAA Division I-FCS,3555,3848,7403,2,"Private nonprofit, 4-year or above",2,17,15,21990,373834,15797,236953,610787,1501742,1286316,2788058,1501742,1286316,2788058,Basketball
166124,College of the Holy Cross,MA,2,NCAA Division I-FCS,1375,1687,3062,2,"Private nonprofit, 4-year or above",2,14,12,37714,527992,33252,399026,927018,2680908,2070879,4751787,2680908,2070879,4751787,Basketball
166513,University of Massachusetts-Lowell,MA,3,NCAA Division I without football,5667,3956,9623,1,"Public, 4-year or above",2,14,12,29003,406037,24814,297762,703799,2283748,1497773,3781521,2283748,1497773,3781521,Basketball
166629,University of Massachusetts-Amherst,MA,1,NCAA Division I-FBS,11152,11677,22829,1,"Public, 4-year or above",2,17,39,56269,956578,25567,997101,1953679,5827846,3433239,9261085,5827846,3433239,9261085,Basketball
166850,Merrimack College,MA,2,NCAA Division I-FCS,1842,2143,3985,2,"Private nonprofit, 4-year or above",2,15,14,27408,411121,17614,246593,657714,1962027,1565393,3527420,1962027,1565393,3527420,Basketball
167358,Northeastern University,MA,3,NCAA Division I without football,7100,9072,16172,2,"Private nonprofit, 4-year or above",2,13,16,55475,721176,25854,413660,1134836,3733297,2785868,6519165,3733297,2785868,6519165,Basketball
167996,Stonehill College,MA,2,NCAA Division I-FCS,1091,1347,2438,2,"Private nonprofit, 4-year or above",2,17,12,12336,209719,17424,209087,418806,1356733,1429266,2785999,1356733,1429266,2785999,Basketball
169248,Central Michigan University,MI,1,NCAA Division I-FBS,3549,5376,8925,1,"Public, 4-year or above",2,16,14,31553,504846,23878,334291,839137,2409265,2148544,4557809,2409265,2148544,4557809,Basketball
169716,University of Detroit Mercy,MI,3,NCAA Division I without football,751,1389,2140,2,"Private nonprofit, 4-year or above",2,15,15,40840,612602,19554,293312,905914,2964352,1830488,4794840,2964352,1830488,4794840,Basketball
169798,Eastern Michigan University,MI,1,NCAA Division I-FBS,3208,4957,8165,1,"Public, 4-year or above",2,16,17,26976,431623,18949,322131,753754,2312257,1710986,4023243,2312257,1710986,4023243,Basketball
170976,University of Michigan-Ann Arbor,MI,1,NCAA Division I-FBS,14705,16443,31148,1,"Public, 4-year or above",2,16,30,166238,2659804,52281,1568429,4228233,20902366,912788,21815154,12018804,5494773,17513577,Basketball
171100,Michigan State University,MI,1,NCAA Division I-FBS,17203,18669,35872,1,"Public, 4-year or above",2,14,17,177365,2483111,74304,1263164,3746275,20524534,6371711,26896245,16395751,6371711,22767462,Basketball
171571,Oakland University,MI,3,NCAA Division I without football,4217,6004,10221,1,"Public, 4-year or above",2,15,24,44349,665242,13579,325900,991142,2346417,1431251,3777668,2346417,1431251,3777668,Basketball
172699,Western Michigan University,MI,1,NCAA Division I-FBS,5623,5751,11374,1,"Public, 4-year or above",2,15,14,32860,492904,32334,452676,945580,2141943,1653624,3795567,2141943,1653624,3795567,Basketball
174066,University of Minnesota-Twin Cities,MN,1,NCAA Division I-FBS,12956,15502,28458,1,"Public, 4-year or above",2,14,22,118382,1657350,53201,1170414,2827764,17411807,767229,18179036,8615354,5776462,14391816,Basketball
174914,University of St Thomas,MN,2,NCAA Division I-FCS,2931,2776,5707,2,"Private nonprofit, 4-year or above",2,14,15,28885,404395,17931,268971,673366,1933379,1608323,3541702,1933379,1608323,3541702,Basketball
175342,Alcorn State University,MS,2,NCAA Division I-FCS,690,1327,2017,1,"Public, 4-year or above",2,15,15,7400,111000,8000,120000,231000,749038,713711,1462749,749038,713711,1462749,Basketball
175856,Jackson State University,MS,2,NCAA Division I-FCS,1598,2713,4311,1,"Public, 4-year or above",2,15,16,12607,189101,13675,218802,407903,904479,894573,1799052,904479,894573,1799052,Basketball
176017,University of Mississippi,MS,1,NCAA Division I-FBS,6836,9313,16149,1,"Public, 4-year or above",2,17,14,127101,2160724,139647,1955063,4115787,13421874,7098166,20520040,13421874,7098166,20520040,Basketball
176044,Mississippi Valley State University,MS,2,NCAA Division I-FCS,471,566,1037,1,"Public, 4-year or above",2,18,20,11093,199677,8566,171318,370995,582801,567755,1150556,582801,567755,1150556,Basketball
176080,Mississippi State University,MS,1,NCAA Division I-FBS,8140,8441,16581,1,"Public, 4-year or above",2,17,15,103941,1767002,109578,1643667,3410669,9319188,6140522,15459710,9319188,6140522,15459710,Basketball
176372,University of Southern Mississippi,MS,1,NCAA Division I-FBS,2934,5684,8618,1,"Public, 4-year or above",2,16,20,32552,520826,20209,404185,925011,1997985,1603940,3601925,1997985,1603940,3601925,Basketball
177968,Lindenwood University,MO,2,NCAA Division I-FCS,1756,2254,4010,2,"Private nonprofit, 4-year or above",2,17,13,8584,145926,8471,110128,256054,912636,826397,1739033,912636,826397,1739033,Basketball
178396,University of Missouri-Columbia,MO,1,NCAA Division I-FBS,9963,11990,21953,1,"Public, 4-year or above",2,15,13,174883,2623246,100258,1303350,3926596,14852293,4341457,19193750,14178273,4341457,18519730,Basketball
178402,University of Missouri-Kansas City,MO,3,NCAA Division I without football,2143,3404,5547,1,"Public, 4-year or above",2,24,27,27565,661562,13260,358012,1019574,2822341,1981204,4803545,2822341,1789650,4611991,Basketball
179159,Saint Louis University,MO,3,NCAA Division I without football,2564,4115,6679,2,"Private nonprofit, 4-year or above",2,16,18,105030,1680484,52495,944902,2625386,7959854,3433542,11393396,7959854,3433542,11393396,Basketball
179557,Southeast Missouri State University,MO,2,NCAA Division I-FCS,2486,3716,6202,1,"Public, 4-year or above",2,15,15,17647,264710,11689,175328,440038,1529076,1064316,2593392,1529076,1064316,2593392,Basketball
179566,Missouri State University-Springfield,MO,2,NCAA Division I-FCS,4352,6898,11250,1,"Public, 4-year or above",2,17,20,58224,989802,32200,643990,1633792,3209480,2164834,5374314,3209480,2164834,5374314,Basketball
180461,Montana State University,MT,2,NCAA Division I-FCS,6650,5815,12465,1,"Public, 4-year or above",2,14,16,42865,600115,28077,449237,1049352,2453139,1726372,4179511,2887114,2051113,4938227,Basketball
180489,The University of Montana,MT,2,NCAA Division I-FCS,2429,3352,5781,1,"Public, 4-year or above",2,16,14,11800,188805,11047,154653,343458,1727892,1695994,3423886,2613960,1695994,4309954,Basketball
181002,Creighton University,NE,3,NCAA Division I without football,1736,2436,4172,2,"Private nonprofit, 4-year or above",2,16,12,136045,2176727,76863,922351,3099078,16834128,1214174,18048302,13153866,2581813,15735679,Basketball
181394,University of Nebraska at Omaha,NE,3,NCAA Division I without football,4262,5691,9953,1,"Public, 4-year or above",2,16,14,37952,607228,21734,304278,911506,2694850,2137455,4832305,2889971,1651244,4541215,Basketball
181464,University of Nebraska-Lincoln,NE,1,NCAA Division I-FBS,9015,9155,18170,1,"Public, 4-year or above",2,18,41,123222,2217989,35156,1441410,3659399,17288897,1696981,18985878,10195829,5146780,15342609,Basketball
182281,University of Nevada-Las Vegas,NV,1,NCAA Division I-FBS,8407,11128,19535,1,"Public, 4-year or above",2,15,12,47569,713534,47050,564600,1278134,4727314,2335267,7062581,4727314,2335267,7062581,Basketball
182290,University of Nevada-Reno,NV,1,NCAA Division I-FBS,6459,7288,13747,1,"Public, 4-year or above",2,14,14,108067,1512936,47613,666584,2179520,5241656,2456852,7698508,5241656,2456852,7698508,Basketball
182670,Dartmouth College,NH,2,NCAA Division I-FCS,2244,2167,4411,2,"Private nonprofit, 4-year or above",2,18,20,22648,407664,16347,326940,734604,1341563,1568851,2910414,1341563,1568851,2910414,Basketball
183044,University of New Hampshire-Main Campus,NH,2,NCAA Division I-FCS,4842,6341,11183,1,"Public, 4-year or above",2,13,12,23171,301219,19878,238534,539753,1497649,1145877,2643526,1497649,1145877,2643526,Basketball
184603,Fairleigh Dickinson University-Metropolitan Campus,NJ,3,NCAA Division I without football,902,987,1889,2,"Private nonprofit, 4-year or above",2,15,15,28018,420271,14536,218047,638318,1887154,1400150,3287304,1887154,1400150,3287304,Basketball
185572,Monmouth University,NJ,2,NCAA Division I-FCS,1333,2326,3659,2,"Private nonprofit, 4-year or above",2,14,13,30315,424406,23942,311251,735657,3013419,2085512,5098931,3013419,2085512,5098931,Basketball
185828,New Jersey Institute of Technology,NJ,3,NCAA Division I without football,5393,1989,7382,1,"Public, 4-year or above",2,14,16,20363,285081,12995,207926,493007,2297939,1796486,4094425,2297939,1787414,4085353,Basketball
186131,Princeton University,NJ,2,NCAA Division I-FCS,2762,2765,5527,2,"Private nonprofit, 4-year or above",2,17,15,44542,757215,32424,486361,1243576,2172036,1452306,3624342,2172036,1452306,3624342,Basketball
186283,Rider University,NJ,3,NCAA Division I without football,1283,1669,2952,2,"Private nonprofit, 4-year or above",2,16,14,14647,234356,7904,110656,345012,2284959,1442258,3727217,2284959,1442258,3727217,Basketball
186380,Rutgers University-New Brunswick,NJ,1,NCAA Division I-FBS,17318,17312,34630,1,"Public, 4-year or above",2,16,22,166881,2670098,90107,1982343,4652441,13483073,7807108,21290181,13483073,7807108,21290181,Basketball
186432,Saint Peter's University,NJ,3,NCAA Division I without football,697,1097,1794,2,"Private nonprofit, 4-year or above",2,13,12,25538,331997,14302,171627,503624,2081123,1187746,3268869,2081123,1187746,3268869,Basketball
186584,Seton Hall University,NJ,3,NCAA Division I without football,2551,3183,5734,2,"Private nonprofit, 4-year or above",2,16,13,126326,2021212,87494,1137416,3158628,8607797,3726920,12334717,8607796,3726920,12334716,Basketball
187985,University of New Mexico-Main Campus,NM,1,NCAA Division I-FBS,5034,6880,11914,1,"Public, 4-year or above",2,15,15,54911,823661,37314,559708,1383369,5111106,2778178,7889284,4908879,2778178,7687057,Basketball
188030,New Mexico State University-Main Campus,NM,1,NCAA Division I-FBS,3874,5448,9322,1,"Public, 4-year or above",2,19,18,40960,778241,30428,547696,1325937,3180322,2013722,5194044,3180322,2013722,5194044,Basketball
189705,Canisius College,NY,3,NCAA Division I without football,852,855,1707,2,"Private nonprofit, 4-year or above",2,14,15,24652,345123,17130,256946,602069,1754546,1588442,3342988,1754546,1588442,3342988,Basketball
190099,Colgate University,NY,2,NCAA Division I-FCS,1383,1729,3112,2,"Private nonprofit, 4-year or above",2,13,17,31076,403983,15483,263207,667190,2750547,2134657,4885204,2750547,2134657,4885204,Basketball
190150,Columbia University in the City of New York,NY,2,NCAA Division I-FCS,4218,4045,8263,2,"Private nonprofit, 4-year or above",2,15,15,21975,329632,35498,532472,862104,1508200,1876368,3384568,1508200,1876368,3384568,Basketball
190415,Cornell University,NY,2,NCAA Division I-FCS,7105,8522,15627,2,"Private nonprofit, 4-year or above",2,19,18,12402,235632,10204,183672,419304,1304541,1062103,2366644,1304541,1062103,2366644,Basketball
191241,Fordham University,NY,2,NCAA Division I-FCS,3803,5810,9613,2,"Private nonprofit, 4-year or above",2,17,25,110525,1878929,38802,970062,2848991,7996715,4135372,12132087,7996715,4135372,12132087,Basketball
191649,Hofstra University,NY,3,NCAA Division I without football,2490,3328,5818,2,"Private nonprofit, 4-year or above",2,15,13,45945,689170,24123,313604,1002774,4174081,2557466,6731547,4174081,2557466,6731547,Basketball
191931,Iona University,NY,2,NCAA Division I-FCS,1233,1368,2601,2,"Private nonprofit, 4-year or above",2,14,14,103666,1451328,36722,514102,1965430,4885531,2304097,7189628,4885531,2304097,7189628,Basketball
192448,Long Island University,NY,2,NCAA Division I-FCS,1795,3430,5225,2,"Private nonprofit, 4-year or above",2,16,17,25186,402982,19038,323654,726636,3229313,1967650,5196963,3229313,1967650,5196963,Basketball
192703,Manhattan College,NY,3,NCAA Division I without football,1682,1236,2918,2,"Private nonprofit, 4-year or above",2,19,15,35803,680257,24663,369938,1050195,2654726,2045306,4700032,2654726,2045306,4700032,Basketball
192819,Marist College,NY,2,NCAA Division I-FCS,2025,2889,4914,2,"Private nonprofit, 4-year or above",2,14,15,29771,416796,18848,282725,699521,2294053,2001289,4295342,2294053,2001289,4295342,Basketball
193973,Niagara University,NY,3,NCAA Division I without football,920,1702,2622,2,"Private nonprofit, 4-year or above",2,14,15,38496,538943,33234,498509,1037452,2387415,1966721,4354136,2387415,1966721,4354136,Basketball
195164,St Bonaventure University,NY,3,NCAA Division I without football,981,790,1771,2,"Private nonprofit, 4-year or above",2,15,14,81565,1223480,30773,430823,1654303,5246527,2214240,7460767,5246527,2214240,7460767,Basketball
195474,Siena College,NY,3,NCAA Division I without football,1527,1896,3423,2,"Private nonprofit, 4-year or above",2,17,13,78432,1333351,23712,308251,1641602,3315499,2079579,5395078,3315499,2079579,5395078,Basketball
195809,St. John's University-New York,NY,3,NCAA Division I without football,4412,5438,9850,2,"Private nonprofit, 4-year or above",2,17,18,132167,2246846,55997,1007943,3254789,12034922,3935032,15969954,12034922,3935032,15969954,Basketball
196060,SUNY at Albany,NY,2,NCAA Division I-FCS,5240,6295,11535,1,"Public, 4-year or above",2,13,14,32751,425761,19428,271994,697755,2254828,1719885,3974713,2020013,1665800,3685813,Basketball
196079,Binghamton University,NY,3,NCAA Division I without football,6644,7436,14080,1,"Public, 4-year or above",2,12,16,22455,269464,14435,230966,500430,2131644,1897941,4029585,2131644,1897941,4029585,Basketball
196088,University at Buffalo,NY,1,NCAA Division I-FBS,10360,8686,19046,1,"Public, 4-year or above",2,14,12,61237,857311,34525,414298,1271609,3830991,1701595,5532586,3830991,1701595,5532586,Basketball
196097,Stony Brook University,NY,2,NCAA Division I-FCS,7988,8326,16314,1,"Public, 4-year or above",2,14,13,59476,832662,30177,392298,1224960,3282312,2070398,5352710,3282312,2070398,5352710,Basketball
196413,Syracuse University,NY,1,NCAA Division I-FBS,6620,7981,14601,2,"Private nonprofit, 4-year or above",2,17,14,143536,2440113,119742,1676381,4116494,32350259,2315607,34665866,21376616,5798511,27175127,Basketball
197197,Wagner College,NY,2,NCAA Division I-FCS,586,982,1568,2,"Private nonprofit, 4-year or above",2,13,13,16241,211139,15142,196847,407986,1843635,1503680,3347315,1843635,1503680,3347315,Basketball
197869,Appalachian State University,NC,1,NCAA Division I-FBS,7552,9767,17319,1,"Public, 4-year or above",2,15,18,38942,584128,22448,404067,988195,1993894,1531979,3525873,1993894,1531979,3525873,Basketball
198136,Campbell University,NC,2,NCAA Division I-FCS,1130,1335,2465,2,"Private nonprofit, 4-year or above",2,16,11,26688,427001,27424,301661,728662,1949494,1474662,3424156,1949494,1474662,3424156,Basketball
198385,Davidson College,NC,2,NCAA Division I-FCS,898,1024,1922,2,"Private nonprofit, 4-year or above",2,16,15,58213,931410,20460,306897,1238307,3693837,2124221,5818058,3530034,2216438,5746472,Basketball
198419,Duke University,NC,1,NCAA Division I-FBS,3114,3429,6543,2,"Private nonprofit, 4-year or above",2,14,15,289841,4057779,105036,1575538,5633317,43918436,5266861,49185297,21404045,8167677,29571722,Basketball
198464,East Carolina University,NC,1,NCAA Division I-FBS,7515,10070,17585,1,"Public, 4-year or above",2,16,15,68804,1100866,49552,743273,1844139,4406802,2659948,7066750,4396277,2648010,7044287,Basketball
198516,Elon University,NC,2,NCAA Division I-FCS,2476,3668,6144,2,"Private nonprofit, 4-year or above",2,14,19,42743,598407,22340,424467,1022874,2691795,2140705,4832500,2691795,2140705,4832500,Basketball
198561,Gardner-Webb University,NC,2,NCAA Division I-FCS,610,906,1516,2,"Private nonprofit, 4-year or above",2,17,15,11568,196656,12261,183915,380571,1254276,1028032,2282308,1254276,1028032,2282308,Basketball
198695,High Point University,NC,3,NCAA Division I without football,2203,2722,4925,2,"Private nonprofit, 4-year or above",2,16,14,36834,589341,25383,355363,944704,2831825,2049451,4881276,2543376,1926500,4469876,Basketball
199102,North Carolina A & T State University,NC,2,NCAA Division I-FCS,3770,6693,10463,1,"Public, 4-year or above",2,17,15,33253,565296,30407,456104,1021400,1565988,1434906,3000894,1566280,1445954,3012234,Basketball
199111,University of North Carolina at Asheville,NC,3,NCAA Division I without football,1041,1478,2519,1,"Public, 4-year or above",2,15,13,22871,343061,15352,199576,542637,1111353,883059,1994412,1111353,883059,1994412,Basketball
199120,University of North Carolina at Chapel Hill,NC,1,NCAA Division I-FBS,7532,11630,19162,1,"Public, 4-year or above",2,18,26,248289,4469210,61534,1599877,6069087,31745487,1025627,32771114,10759922,5801731,16561653,Basketball
199139,University of North Carolina at Charlotte,NC,1,NCAA Division I-FBS,10321,9668,19989,1,"Public, 4-year or above",2,15,19,72458,1086867,36115,686178,1773045,3658850,2250029,5908879,3658850,2250029,5908879,Basketball
199148,University of North Carolina at Greensboro,NC,3,NCAA Division I without football,3883,7651,11534,1,"Public, 4-year or above",2,16,15,26165,418642,16386,245795,664437,2484156,1714508,4198664,2484156,1714508,4198664,Basketball
199157,North Carolina Central University,NC,2,NCAA Division I-FCS,1380,3096,4476,1,"Public, 4-year or above",2,16,13,21312,340987,3043,39562,380549,1555938,1188245,2744183,1555938,1188245,2744183,Basketball
199193,North Carolina State University at Raleigh,NC,1,NCAA Division I-FBS,11800,11845,23645,1,"Public, 4-year or above",2,15,11,135049,2025729,124725,1371973,3397702,18662255,1094870,19757125,10511126,4928097,15439223,Basketball
199218,University of North Carolina Wilmington,NC,3,NCAA Division I without football,4388,7321,11709,1,"Public, 4-year or above",2,15,16,39751,596271,15578,249240,845511,2831698,1290484,4122182,2831698,1290484,4122182,Basketball
199412,Queens University of Charlotte,NC,3,NCAA Division I without football,445,789,1234,2,"Private nonprofit, 4-year or above",2,13,16,29103,378337,14311,228971,607308,1540704,1311531,2852235,1540704,1311531,2852235,Basketball
199847,Wake Forest University,NC,1,NCAA Division I-FBS,2410,2978,5388,2,"Private nonprofit, 4-year or above",2,17,27,148281,2520773,47608,1285413,3806186,11335404,5315051,16650455,11335404,5315051,16650455,Basketball
200004,Western Carolina University,NC,2,NCAA Division I-FCS,3501,4476,7977,1,"Public, 4-year or above",2,16,14,15257,244113,12386,173409,417522,1557165,1120929,2678094,1557165,1120929,2678094,Basketball
200280,University of North Dakota,ND,2,NCAA Division I-FCS,3641,3350,6991,1,"Public, 4-year or above",2,14,24,36307,508300,19215,461151,969451,2144905,2040553,4185458,2144904,2040553,4185457,Basketball
200332,North Dakota State University-Main Campus,ND,2,NCAA Division I-FCS,4473,4429,8902,1,"Public, 4-year or above",2,13,14,40866,531258,41157,576194,1107452,1765843,1714139,3479982,1765843,1714139,3479982,Basketball
200800,University of Akron Main Campus,OH,1,NCAA Division I-FBS,4498,4019,8517,1,"Public, 4-year or above",2,15,19,48476,727133,17529,333042,1060175,3324785,1659382,4984167,3324785,1659382,4984167,Basketball
201441,Bowling Green State University-Main Campus,OH,1,NCAA Division I-FBS,4887,6609,11496,1,"Public, 4-year or above",2,15,15,38275,574124,33014,495214,1069338,3266592,1507593,4774185,3266592,1507593,4774185,Basketball
201885,University of Cincinnati-Main Campus,OH,1,NCAA Division I-FBS,12694,12171,24865,1,"Public, 4-year or above",2,15,15,203925,3058869,66789,1001829,4060698,9011526,3630317,12641843,9011526,3630317,12641843,Basketball
202134,Cleveland State University,OH,3,NCAA Division I without football,3578,4204,7782,1,"Public, 4-year or above",2,14,13,34343,480807,32430,421585,902392,2624527,1738740,4363267,2658162,1733740,4391902,Basketball
202480,University of Dayton,OH,2,NCAA Division I-FCS,4218,3872,8090,2,"Private nonprofit, 4-year or above",2,16,11,154436,2470977,88768,976444,3447421,17760511,1424208,19184719,9381496,3665842,13047338,Basketball
203517,Kent State University at Kent,OH,1,NCAA Division I-FBS,6185,10484,16669,1,"Public, 4-year or above",2,20,19,30821,616419,10410,197795,814214,2433919,1374484,3808403,2433919,1374484,3808403,Basketball
204024,Miami University-Oxford,OH,1,NCAA Division I-FBS,7875,8527,16402,1,"Public, 4-year or above",2,15,26,31372,470574,13263,344843,815417,2437764,1820631,4258395,2437764,1820631,4258395,Basketball
204796,Ohio State University-Main Campus,OH,1,NCAA Division I-FBS,20955,21231,42186,1,"Public, 4-year or above",2,14,14,210927,2952976,142261,1991654,4944630,23638698,1277839,24916537,13062023,6565977,19628000,Basketball
204857,Ohio University-Main Campus,OH,1,NCAA Division I-FBS,6262,8346,14608,1,"Public, 4-year or above",2,15,14,49767,746506,20830,291626,1038132,3513702,1829481,5343183,3513702,1829481,5343183,Basketball
206084,University of Toledo,OH,1,NCAA Division I-FBS,4708,4866,9574,1,"Public, 4-year or above",2,14,30,25630,358814,9939,298167,656981,2806550,2460452,5267002,2806550,2460452,5267002,Basketball
206604,Wright State University-Main Campus,OH,3,NCAA Division I without football,2256,2854,5110,1,"Public, 4-year or above",2,15,16,41759,626379,15572,249156,875535,2908239,1546763,4455002,2908239,1546763,4455002,Basketball
206622,Xavier University,OH,3,NCAA Division I without football,2042,2571,4613,2,"Private nonprofit, 4-year or above",2,16,15,205721,3291539,48464,726966,4018505,17336759,2732881,20069640,13415361,2976980,16392341,Basketball
206695,Youngstown State University,OH,2,NCAA Division I-FCS,3149,3712,6861,1,"Public, 4-year or above",2,14,15,34601,484416,17328,259924,744340,2017741,1294847,3312588,2017741,1294847,3312588,Basketball
207388,Oklahoma State University-Main Campus,OK,1,NCAA Division I-FBS,8740,9480,18220,1,"Public, 4-year or above",2,15,25,167388,2510825,61823,1545586,4056411,14991097,1032938,16024035,9607887,4669466,14277353,Basketball
207500,University of Oklahoma-Norman Campus,OK,1,NCAA Division I-FBS,8954,9525,18479,1,"Public, 4-year or above",2,15,23,141136,2117034,76243,1753588,3870622,14478267,3075625,17553892,12129422,6399371,18528793,Basketball
207582,Oral Roberts University,OK,3,NCAA Division I without football,1086,1663,2749,2,"Private nonprofit, 4-year or above",2,15,15,60932,913973,24180,362695,1276668,2888076,1577138,4465214,2794687,1577138,4371825,Basketball
207971,University of Tulsa,OK,1,NCAA Division I-FBS,1159,1254,2413,2,"Private nonprofit, 4-year or above",2,13,27,73291,952787,24386,658435,1611222,5511388,3517756,9029144,5511388,3517756,9029144,Basketball
209542,Oregon State University,OR,1,NCAA Division I-FBS,10119,9588,19707,1,"Public, 4-year or above",2,15,31,104294,1564412,38241,1185480,2749892,7838931,4673877,12512808,7085122,4673877,11758999,Basketball
209551,University of Oregon,OR,1,NCAA Division I-FBS,8035,10150,18185,1,"Public, 4-year or above",2,16,25,124596,1993531,52851,1321285,3314816,10271432,1866359,12137791,11919466,5189434,17108900,Basketball
209807,Portland State University,OR,2,NCAA Division I-FCS,4641,6326,10967,1,"Public, 4-year or above",2,14,15,32471,454600,20159,302387,756987,1956434,1469920,3426354,1956434,1469920,3426354,Basketball
209825,University of Portland,OR,3,NCAA Division I without football,1190,2119,3309,2,"Private nonprofit, 4-year or above",2,18,17,35922,646598,24769,421075,1067673,3232882,2251592,5484474,3232882,2251592,5484474,Basketball
211291,Bucknell University,PA,2,NCAA Division I-FCS,1796,1935,3731,2,"Private nonprofit, 4-year or above",2,14,22,30645,429031,11414,251098,680129,3229655,2037256,5266911,3229655,2037256,5266911,Basketball
212054,Drexel University,PA,3,NCAA Division I without football,6682,6172,12854,2,"Private nonprofit, 4-year or above",2,15,28,50111,751670,23529,658825,1410495,3173839,2866093,6039932,3173839,2866093,6039932,Basketball
212106,Duquesne University,PA,2,NCAA Division I-FCS,1830,3186,5016,2,"Private nonprofit, 4-year or above",2,18,15,81385,1464921,29571,443569,1908490,5653680,2604391,8258071,5653680,2604391,8258071,Basketball
213367,La Salle University,PA,3,NCAA Division I without football,760,1234,1994,2,"Private nonprofit, 4-year or above",2,15,14,53318,799768,21403,299640,1099408,3576933,1584346,5161279,3576933,1584346,5161279,Basketball
213385,Lafayette College,PA,2,NCAA Division I-FCS,1355,1357,2712,2,"Private nonprofit, 4-year or above",2,15,11,25456,381841,22596,248561,630402,2347981,1975294,4323275,2347981,1975294,4323275,Basketball
213543,Lehigh University,PA,2,NCAA Division I-FCS,2998,2552,5550,2,"Private nonprofit, 4-year or above",2,17,14,18468,313960,17640,246966,560926,2105777,1896155,4001932,2105777,1896155,4001932,Basketball
214777,Pennsylvania State University-Main Campus,PA,1,NCAA Division I-FBS,21343,19132,40475,1,"Public, 4-year or above",2,16,14,138753,2220047,115945,1623225,3843272,16583320,1102841,17686161,13059514,5021216,18080730,Basketball
215062,University of Pennsylvania,PA,2,NCAA Division I-FCS,4611,5542,10153,2,"Private nonprofit, 4-year or above",2,26,18,13866,360521,19400,349203,709724,1897675,1202581,3100256,1897675,1202581,3100256,Basketball
215293,University of Pittsburgh-Pittsburgh Campus,PA,1,NCAA Division I-FBS,8129,11104,19233,1,"Public, 4-year or above",2,15,29,232763,3491452,52590,1525110,5016562,14746383,5220185,19966568,12352136,5220185,17572321,Basketball
215655,Robert Morris University,PA,2,NCAA Division I-FCS,1437,1145,2582,2,"Private nonprofit, 4-year or above",2,13,14,34892,453591,19219,269061,722652,2304643,1562764,3867407,2304643,1562764,3867407,Basketball
215743,Saint Francis University,PA,2,NCAA Division I-FCS,560,930,1490,2,"Private nonprofit, 4-year or above",2,19,16,21762,413483,17730,283685,697168,1853791,1618560,3472351,1853791,1618560,3472351,Basketball
215770,Saint Joseph's University,PA,3,NCAA Division I without football,2174,2634,4808,2,"Private nonprofit, 4-year or above",2,16,12,75375,1205997,38857,466285,1672282,5778456,2826545,8605001,5778456,2826545,8605001,Basketball
216339,Temple University,PA,1,NCAA Division I-FBS,9531,12387,21918,1,"Public, 4-year or above",2,15,14,98971,1484562,61672,863407,2347969,8606016,4595454,13201470,8606016,4595454,13201470,Basketball
216597,Villanova University,PA,2,NCAA Division I-FCS,3099,3653,6752,2,"Private nonprofit, 4-year or above",2,13,18,274829,3572774,94567,1702206,5274980,18563546,4570612,23134158,12050966,4570612,16621578,Basketball
217156,Brown University,RI,2,NCAA Division I-FCS,3532,3634,7166,2,"Private nonprofit, 4-year or above",2,15,20,28076,421133,16924,338480,759613,1498059,1084229,2582288,1498059,1084229,2582288,Basketball
217165,Bryant University,RI,2,NCAA Division I-FCS,2020,1150,3170,2,"Private nonprofit, 4-year or above",2,17,23,31263,531471,12272,282265,813736,2569775,1689098,4258873,2569775,1689098,4258873,Basketball
217484,University of Rhode Island,RI,2,NCAA Division I-FCS,5481,7419,12900,1,"Public, 4-year or above",2,14,14,132309,1852329,69149,968090,2820419,6414386,3296617,9711003,6464940,3338287,9803227,Basketball
217688,Charleston Southern University,SC,2,NCAA Division I-FCS,928,1655,2583,2,"Private nonprofit, 4-year or above",2,15,13,27456,411844,13737,178576,590420,1451686,1017180,2468866,1451686,1017180,2468866,Basketball
217819,College of Charleston,SC,3,NCAA Division I without football,2941,6207,9148,1,"Public, 4-year or above",2,19,18,59930,1138668,18727,337084,1475752,4267728,2007210,6274938,4267728,2007210,6274938,Basketball
217864,Citadel Military College of South Carolina,SC,2,NCAA Division I-FCS,2137,332,2469,1,"Public, 4-year or above",2,17,,29497,501444,0,0,501444,1800444,,1800444,1961506,,1961506,Basketball
217882,Clemson University,SC,1,NCAA Division I-FBS,10225,11489,21714,1,"Public, 4-year or above",2,16,14,92663,1482610,75814,1061396,2544006,8587001,4869129,13456130,8587001,4869129,13456130,Basketball
218070,Furman University,SC,2,NCAA Division I-FCS,928,1331,2259,2,"Private nonprofit, 4-year or above",2,15,15,57459,861879,14235,213525,1075404,4374444,2170154,6544598,4374444,2170154,6544598,Basketball
218663,University of South Carolina-Columbia,SC,1,NCAA Division I-FBS,11235,14725,25960,1,"Public, 4-year or above",2,14,28,99535,1393484,57906,1621356,3014840,11564622,10767616,22332238,7953678,10767616,18721294,Basketball
218724,Coastal Carolina University,SC,1,NCAA Division I-FBS,3997,4992,8989,1,"Public, 4-year or above",2,14,14,34188,478626,25053,350735,829361,2304252,1955765,4260017,2304252,1955765,4260017,Basketball
218733,South Carolina State University,SC,2,NCAA Division I-FCS,965,1149,2114,1,"Public, 4-year or above",2,13,16,30482,396272,13126,210009,606281,1561866,1106249,2668115,1087769,1130582,2218351,Basketball
218742,University of South Carolina-Upstate,SC,3,NCAA Division I without football,1147,2367,3514,1,"Public, 4-year or above",2,15,13,14387,215804,9406,122281,338085,1281174,1001770,2282944,1281174,1001770,2282944,Basketball
218964,Winthrop University,SC,3,NCAA Division I without football,1063,2110,3173,1,"Public, 4-year or above",2,15,15,22442,336633,10164,152463,489096,1619253,1084133,2703386,1619253,1084133,2703386,Basketball
218973,Wofford College,SC,2,NCAA Division I-FCS,860,947,1807,2,"Private nonprofit, 4-year or above",2,16,12,24971,399529,27805,333654,733183,2103166,1672417,3775583,2103166,1672417,3775583,Basketball
219356,South Dakota State University,SD,2,NCAA Division I-FCS,3562,4020,7582,1,"Public, 4-year or above",2,13,15,62934,818145,39040,585597,1403742,2193628,1841981,4035609,2193628,1841981,4035609,Basketball
219471,University of South Dakota,SD,2,NCAA Division I-FCS,1615,2885,4500,1,"Public, 4-year or above",2,16,14,16932,270911,26434,370081,640992,1703877,1693885,3397762,1703877,1693885,3397762,Basketball
219602,Austin Peay State University,TN,2,NCAA Division I-FCS,2089,3183,5272,1,"Public, 4-year or above",2,16,13,29688,475001,23074,299960,774961,2213450,1303752,3517202,2213450,1303752,3517202,Basketball
219709,Belmont University,TN,3,NCAA Division I without football,2347,4740,7087,2,"Private nonprofit, 4-year or above",2,15,12,42575,638621,45470,545644,1184265,3635804,2508253,6144057,3635804,2508253,6144057,Basketball
219976,Lipscomb University,TN,3,NCAA Division I without football,1088,1703,2791,2,"Private nonprofit, 4-year or above",2,16,12,27788,444605,29415,352981,797586,2296071,1455052,3751123,2296071,1455052,3751123,Basketball
220075,East Tennessee State University,TN,2,NCAA Division I-FCS,3319,5132,8451,1,"Public, 4-year or above",2,16,14,19549,312789,17464,244492,557281,2159945,1716784,3876729,2159945,1716784,3876729,Basketball
220862,University of Memphis,TN,1,NCAA Division I-FBS,4365,6547,10912,1,"Public, 4-year or above",2,16,15,165384,2646145,120423,1806347,4452492,9757765,4060388,13818153,9757765,4060388,13818153,Basketball
220978,Middle Tennessee State University,TN,1,NCAA Division I-FBS,6559,7285,13844,1,"Public, 4-year or above",2,15,14,61137,917049,60243,843400,1760449,3137205,2755393,5892598,3137205,2755393,5892598,Basketball
221740,The University of Tennessee-Chattanooga,TN,2,NCAA Division I-FCS,3687,5192,8879,1,"Public, 4-year or above",2,14,12,33606,470484,20863,250355,720839,1920140,1596654,3516794,1920140,1596654,3516794,Basketball
221759,The University of Tennessee-Knoxville,TN,1,NCAA Division I-FBS,11679,14119,25798,1,"Public, 4-year or above",2,18,34,206279,3713022,73853,2511002,6224024,19097170,3237076,22334246,15619680,7538346,23158026,Basketball
221768,The University of Tennessee-Martin,TN,2,NCAA Division I-FCS,1627,2632,4259,1,"Public, 4-year or above",2,15,18,14126,211883,12915,232477,444360,1432529,1192200,2624729,1481700,1224740,2706440,Basketball
221838,Tennessee State University,TN,2,NCAA Division I-FCS,2256,4424,6680,1,"Public, 4-year or above",2,15,15,23412,351185,15349,230238,581423,1693147,1239842,2932989,1693147,1239842,2932989,Basketball
221847,Tennessee Technological University,TN,2,NCAA Division I-FCS,4206,3508,7714,1,"Public, 4-year or above",2,17,14,17741,301592,25084,351180,652772,1573261,1440693,3013954,1573261,1440693,3013954,Basketball
221999,Vanderbilt University,TN,1,NCAA Division I-FBS,3401,3677,7078,2,"Private nonprofit, 4-year or above",2,16,22,171530,2744473,96093,2114038,4858511,14586531,7915818,22502349,14586531,7915818,22502349,Basketball
222178,Abilene Christian University,TX,2,NCAA Division I-FCS,1163,1892,3055,2,"Private nonprofit, 4-year or above",2,15,13,42527,637902,32059,416767,1054669,2458334,1592885,4051219,2322034,1773173,4095207,Basketball
223232,Baylor University,TX,1,NCAA Division I-FBS,6008,8877,14885,2,"Private nonprofit, 4-year or above",2,15,36,175201,2628017,61264,2205511,4833528,16055194,9796088,25851282,16055194,9796088,25851282,Basketball
224147,Texas A & M University-Corpus Christi,TX,3,NCAA Division I without football,2360,3652,6012,1,"Public, 4-year or above",2,16,24,40483,647721,19457,466957,1114678,2401821,1734409,4136230,2401821,1734409,4136230,Basketball
224554,Texas A & M University-Commerce,TX,2,NCAA Division I-FCS,2108,3216,5324,1,"Public, 4-year or above",2,14,16,28057,392803,16755,268076,660879,1716524,1420572,3137096,1690213,1384648,3074861,Basketball
225399,Houston Baptist University,TX,2,NCAA Division I-FCS,825,1327,2152,2,"Private nonprofit, 4-year or above",2,17,15,28472,484025,10183,152742,636767,1668785,1146476,2815261,1668785,1146476,2815261,Basketball
225511,University of Houston,TX,1,NCAA Division I-FBS,12597,14466,27063,1,"Public, 4-year or above",2,13,16,151640,1971326,42889,686231,2657557,11117868,2672885,13790753,11117868,2672885,13790753,Basketball
225627,University of the Incarnate Word,TX,2,NCAA Division I-FCS,1384,2556,3940,2,"Private nonprofit, 4-year or above",2,19,14,13366,253945,10652,149125,403070,2117667,1304919,3422586,2117667,1304919,3422586,Basketball
226091,Lamar University,TX,2,NCAA Division I-FCS,2474,3681,6155,1,"Public, 4-year or above",2,16,14,15992,255871,17828,249595,505466,1575969,1236796,2812765,1575969,1236796,2812765,Basketball
227216,University of North Texas,TX,1,NCAA Division I-FBS,11755,14248,26003,1,"Public, 4-year or above",2,16,17,95345,1525521,45489,773311,2298832,4426793,2448323,6875116,4426793,2448323,6875116,Basketball
227368,The University of Texas Rio Grande Valley,TX,3,NCAA Division I without football,7778,11878,19656,1,"Public, 4-year or above",2,16,16,33045,528715,28613,457810,986525,1973230,1487022,3460252,1973230,1487022,3460252,Basketball
227526,Prairie View A & M University,TX,2,NCAA Division I-FCS,2266,4897,7163,1,"Public, 4-year or above",2,16,15,31443,503089,25828,387418,890507,1259630,1089298,2348928,1259630,1089298,2348928,Basketball
227757,Rice University,TX,1,NCAA Division I-FBS,2236,2144,4380,2,"Private nonprofit, 4-year or above",2,16,28,46067,737077,17224,482282,1219359,3465436,2576779,6042215,3465436,2576779,6042215,Basketball
227881,Sam Houston State University,TX,2,NCAA Division I-FCS,5306,9267,14573,1,"Public, 4-year or above",2,15,13,36598,548975,31874,414361,963336,1844534,1407759,3252293,1844534,1407759,3252293,Basketball
228246,Southern Methodist University,TX,1,NCAA Division I-FBS,3383,3497,6880,2,"Private nonprofit, 4-year or above",2,16,15,104483,1671728,68107,1021611,2693339,10618903,4273266,14892169,10618903,4273267,14892170,Basketball
228431,Stephen F Austin State University,TX,2,NCAA Division I-FCS,2871,4961,7832,1,"Public, 4-year or above",2,15,13,52796,791940,47353,615590,1407530,3203671,2299525,5503196,3203671,2299525,5503196,Basketball
228459,Texas State University,TX,1,NCAA Division I-FBS,10984,16775,27759,1,"Public, 4-year or above",2,14,14,49045,686634,38453,538343,1224977,2473989,1901271,4375260,2473989,1901271,4375260,Basketball
228529,Tarleton State University,TX,2,NCAA Division I-FCS,3128,5617,8745,1,"Public, 4-year or above",2,35,41,16999,594976,10541,432178,1027154,1790628,1458836,3249464,1659163,1566530,3225693,Basketball
228723,Texas A & M University-College Station,TX,1,NCAA Division I-FBS,26902,24141,51043,1,"Public, 4-year or above",2,18,13,186586,3358549,141979,1845721,5204270,12899246,901482,13800728,13792475,6973529,20766004,Basketball
228769,The University of Texas at Arlington,TX,3,NCAA Division I without football,8341,10526,18867,1,"Public, 4-year or above",2,15,15,33271,499071,33129,496931,996002,2450008,2016281,4466289,2450008,2016281,4466289,Basketball
228778,The University of Texas at Austin,TX,1,NCAA Division I-FBS,16167,22277,38444,1,"Public, 4-year or above",2,14,28,174106,2437483,64908,1817436,4254919,22629647,2614231,25243878,16092106,10047120,26139226,Basketball
228796,The University of Texas at El Paso,TX,1,NCAA Division I-FBS,6053,7622,13675,1,"Public, 4-year or above",2,17,16,40979,696638,28265,452238,1148876,6049132,1409913,7459045,4012116,1959553,5971669,Basketball
228875,Texas Christian University,TX,1,NCAA Division I-FBS,3939,6387,10326,2,"Private nonprofit, 4-year or above",2,18,29,143559,2584055,51257,1486464,4070519,14094198,6686246,20780444,14576029,8083091,22659120,Basketball
229027,The University of Texas at San Antonio,TX,1,NCAA Division I-FBS,10077,11661,21738,1,"Public, 4-year or above",2,15,20,40113,601693,25689,513780,1115473,2681468,2270138,4951606,2681468,2270138,4951606,Basketball
229063,Texas Southern University,TX,2,NCAA Division I-FCS,1967,3717,5684,1,"Public, 4-year or above",2,13,17,8738,113597,4261,72445,186042,2007659,1126308,3133967,1923581,1201768,3125349,Basketball
229115,Texas Tech University,TX,1,NCAA Division I-FBS,14705,14370,29075,1,"Public, 4-year or above",2,14,14,207220,2901079,129136,1807897,4708976,14477595,2294076,16771671,16173338,5388320,21561658,Basketball
230038,Brigham Young University,UT,1,NCAA Division I-FBS,13555,14699,28254,2,"Private nonprofit, 4-year or above",2,18,19,171123,3080217,62309,1183869,4264086,16602330,1024236,17626566,10685023,3761449,14446472,Basketball
230171,Utah Tech University,UT,2,NCAA Division I-FCS,2784,4193,6977,1,"Public, 4-year or above",2,16,21,29966,479457,16960,356156,835613,1625080,1199804,2824884,1625080,1199804,2824884,Basketball
230603,Southern Utah University,UT,2,NCAA Division I-FCS,3331,4489,7820,1,"Public, 4-year or above",2,18,14,25994,467900,29900,418595,886495,1508533,1250022,2758555,1566836,1311330,2878166,Basketball
230728,Utah State University,UT,1,NCAA Division I-FBS,7565,8999,16564,1,"Public, 4-year or above",2,15,23,86177,1292656,24638,566674,1859330,5079930,2104357,7184287,5079930,2104357,7184287,Basketball
230737,Utah Valley University,UT,3,NCAA Division I without football,9010,8209,17219,1,"Public, 4-year or above",2,17,16,53591,911052,30057,480913,1391965,2301500,1236238,3537738,2301500,1236238,3537738,Basketball
230764,University of Utah,UT,1,NCAA Division I-FBS,10979,10210,21189,1,"Public, 4-year or above",2,16,13,91634,1466136,66992,870901,2337037,15036488,748165,15784653,11803281,4383158,16186439,Basketball
230782,Weber State University,UT,2,NCAA Division I-FCS,4372,5746,10118,1,"Public, 4-year or above",2,16,15,39282,628511,24673,370091,998602,2131322,1414720,3546042,2131322,1414720,3546042,Basketball
231174,University of Vermont,VT,3,NCAA Division I without football,3986,7075,11061,1,"Public, 4-year or above",2,15,15,41148,617219,28312,424687,1041906,2822203,2004160,4826363,2822278,2004568,4826846,Basketball
231624,William & Mary,VA,2,NCAA Division I-FCS,2792,3919,6711,1,"Public, 4-year or above",2,15,14,42303,634551,25555,357764,992315,1982420,1240707,3223127,2987990,2188495,5176485,Basketball
232186,George Mason University,VA,3,NCAA Division I without football,10783,10584,21367,1,"Public, 4-year or above",2,15,15,93774,1406609,55387,830799,2237408,5232391,2994302,8226693,5232391,2994302,8226693,Basketball
232265,Hampton University,VA,2,NCAA Division I-FCS,874,1774,2648,2,"Private nonprofit, 4-year or above",2,16,15,16623,265963,8677,130149,396112,1252370,1168686,2421056,1310584,1100590,2411174,Basketball
232423,James Madison University,VA,2,NCAA Division I-FCS,8075,10848,18923,1,"Public, 4-year or above",2,17,30,59387,1009584,30292,908763,1918347,3900522,3570013,7470535,3900522,3570013,7470535,Basketball
232557,Liberty University,VA,1,NCAA Division I-FBS,13116,17872,30988,2,"Private nonprofit, 4-year or above",2,16,15,69897,1118356,43461,651909,1770265,5080657,2398047,7478704,5080657,2398047,7478704,Basketball
232566,Longwood University,VA,3,NCAA Division I without football,878,1991,2869,1,"Public, 4-year or above",2,17,13,48213,819629,18528,240858,1060487,2795208,1287768,4082976,2789028,1387582,4176610,Basketball
232937,Norfolk State University,VA,2,NCAA Division I-FCS,1524,3094,4618,1,"Public, 4-year or above",2,15,12,29733,446000,17542,210508,656508,1921780,1244343,3166123,1921780,1244343,3166123,Basketball
232982,Old Dominion University,VA,1,NCAA Division I-FBS,6267,7601,13868,1,"Public, 4-year or above",2,15,14,71300,1069504,72386,1013406,2082910,3741903,3085169,6827072,3741903,3085169,6827072,Basketball
233277,Radford University,VA,3,NCAA Division I without football,2067,3411,5478,1,"Public, 4-year or above",2,16,15,25551,408814,13716,205738,614552,1913286,1315098,3228384,1913286,1315098,3228384,Basketball
233374,University of Richmond,VA,2,NCAA Division I-FCS,1368,1585,2953,2,"Private nonprofit, 4-year or above",2,16,14,93577,1497224,42221,591089,2088313,6187344,2829276,9016620,6187344,2829276,9016620,Basketball
233921,Virginia Polytechnic Institute and State University,VA,1,NCAA Division I-FBS,16778,12726,29504,1,"Public, 4-year or above",2,15,13,117386,1760789,98147,1275916,3036705,11754410,1632303,13386713,11676096,4005393,15681489,Basketball
234030,Virginia Commonwealth University,VA,3,NCAA Division I without football,6518,11687,18205,1,"Public, 4-year or above",2,15,33,107184,1607763,37696,1243956,2851719,8461356,4394551,12855907,7225180,4394551,11619731,Basketball
234076,University of Virginia-Main Campus,VA,1,NCAA Division I-FBS,7189,9263,16452,1,"Public, 4-year or above",2,16,34,124500,1992007,35942,1222027,3214034,16228071,4613938,20842009,13903568,4613938,18517506,Basketball
234085,Virginia Military Institute,VA,2,NCAA Division I-FCS,1310,202,1512,1,"Public, 4-year or above",2,16,,25727,411630,0,0,411630,2139006,,2139006,2139006,,2139006,Basketball
235097,Eastern Washington University,WA,2,NCAA Division I-FCS,2687,3563,6250,1,"Public, 4-year or above",2,15,17,35444,531658,17093,290587,822245,1864478,1459657,3324135,1864478,1459657,3324135,Basketball
235316,Gonzaga University,WA,3,NCAA Division I without football,2285,2672,4957,2,"Private nonprofit, 4-year or above",2,17,20,108376,1842398,64270,1285392,3127790,19216086,4401160,23617246,12578321,4926547,17504868,Basketball
236595,Seattle University,WA,3,NCAA Division I without football,1513,2360,3873,2,"Private nonprofit, 4-year or above",2,17,16,87134,1481271,37224,595585,2076856,3217416,2043493,5260909,3217416,2043493,5260909,Basketball
236939,Washington State University,WA,1,NCAA Division I-FBS,9371,10364,19735,1,"Public, 4-year or above",2,17,22,81064,1378094,36575,804651,2182745,6866552,1068332,7934884,5867954,3921403,9789357,Basketball
236948,University of Washington-Seattle Campus,WA,1,NCAA Division I-FBS,12422,16556,28978,1,"Public, 4-year or above",2,17,23,187635,3189789,110499,2541470,5731259,10992854,1666078,12658932,10603549,6538965,17142514,Basketball
237525,Marshall University,WV,1,NCAA Division I-FBS,2679,3625,6304,1,"Public, 4-year or above",2,14,17,73266,1025728,42669,725368,1751096,3884753,2096807,5981560,3884753,2096807,5981560,Basketball
238032,West Virginia University,WV,1,NCAA Division I-FBS,8514,9029,17543,1,"Public, 4-year or above",2,14,13,194193,2718696,130681,1698859,4417555,8713368,3448193,12161561,11185351,4753640,15938991,Basketball
239105,Marquette University,WI,3,NCAA Division I without football,3150,4010,7160,2,"Private nonprofit, 4-year or above",2,18,29,272721,4908977,61666,1788314,6697291,20723046,4814091,25537137,17268167,4814091,22082258,Basketball
240277,University of Wisconsin-Green Bay,WI,3,NCAA Division I without football,1837,2988,4825,1,"Public, 4-year or above",2,14,15,36425,509950,31701,475517,985467,2020431,1701291,3721722,2020431,1701291,3721722,Basketball
240444,University of Wisconsin-Madison,WI,1,NCAA Division I-FBS,15600,17947,33547,1,"Public, 4-year or above",2,16,17,166966,2671448,70047,1190800,3862248,18394677,1230869,19625546,11037237,4419467,15456704,Basketball
240453,University of Wisconsin-Milwaukee,WI,3,NCAA Division I without football,6709,8038,14747,1,"Public, 4-year or above",2,17,14,47668,810354,20082,281147,1091501,3919096,2266845,6185941,3919096,2266845,6185941,Basketball
240727,University of Wyoming,WY,1,NCAA Division I-FBS,3392,3669,7061,1,"Public, 4-year or above",2,15,24,57591,863866,27192,652607,1516473,3506782,2338281,5845063,4097388,2338281,6435669,Basketball
243744,Stanford University,CA,1,NCAA Division I-FBS,3744,4017,7761,2,"Private nonprofit, 4-year or above",2,14,17,113657,1591192,89428,1520280,3111472,8122603,8111552,16234155,8122603,8111552,16234155,Basketball
243780,Purdue University-Main Campus,IN,1,NCAA Division I-FBS,21058,15417,36475,1,"Public, 4-year or above",2,16,13,183327,2933235,115226,1497936,4431171,16311833,6931516,23243349,10494940,4206194,14701134,Basketball
433660,Florida Gulf Coast University,FL,3,NCAA Division I without football,4768,6297,11065,1,"Public, 4-year or above",2,17,15,30139,512360,24276,364142,876502,2264441,2175089,4439530,2264441,2175089,4439530,Basketball
486840,Kennesaw State University,GA,2,NCAA Division I-FCS,14171,14383,28554,1,"Public, 4-year or above",2,16,21,35988,575809,14143,297010,872819,2538955,1666849,4205804,2538955,1666849,4205804,Basketball
