Survey_Year,UNITID,Institution_Name,State_CD,Sanction_Name,Classification_Name,Sport_Name,Male_Undergraduates,Female_Undergraduates,Total_Undergraduates,Num_Participants_Mens_Team,Num_Participants_Womens_Team,Operating_Expenses_per_Participant_Mens_Team,Operating_Expenses_per_Team_Mens_Team,Operating_Expenses_per_Participant_Womens_Team,Operating_Expenses_per_Team_Womens_Team,Total_Operating_Expenses_Mens_Team_and_Womens_Team,Revenues_Mens_Team,Revenues_Womens_Team,Total_Revenues_For_Mens_Team_and_Womens_Team,Expenses_Mens_Team,Expenses_Womens_Team,Total_Expenses_Mens_Team_and_Womens_Team
2022,131159,American University,DC,NCAA,NCAA Division I-without football,Basketball,2633,4778,7411,17,13,20721,352255,22218,288828,641083,2656602,2000835,4657437,2656602,2000835,4657437
2022,197869,Appalachian State University,NC,NCAA,NCAA Division I-FBS,Basketball,7552,9767,17319,15,18,38942,584128,22448,404067,988195,1993894,1531979,3525873,1993894,1531979,3525873
2022,104151,Arizona State University Campus Immersion,AZ,NCAA,NCAA Division I-FBS,Basketball,30113,29652,59765,19,31,88047,1672901,24561,761389,2434290,10057620,4391507,14449127,9009832,4391507,13401339
2022,106458,Arkansas State University,AR,NCAA,NCAA Division I-FBS,Basketball,2103,2992,5095,16,14,40349,645589,30648,429067,1074656,1966573,1373032,3339605,1966573,1373032,3339605
2022,100858,Auburn University,AL,NCAA,NCAA Division I-FBS,Basketball,11355,11591,22946,18,19,141699,2550578,70111,1332116,3882694,19199986,745629,19945615,14997002,5261713,20258715
2022,219602,Austin Peay State University,TN,NCAA,NCAA Division I-FCS,Basketball,2089,3183,5272,16,13,29688,475001,23074,299960,774961,2213450,1303752,3517202,2213450,1303752,3517202
2022,150136,Ball State University,IN,NCAA,NCAA Division I-FBS,Basketball,4909,7711,12620,14,12,36991,517872,37247,446965,964837,2679287,1859524,4538811,2679287,1859524,4538811
2022,223232,Baylor University,TX,NCAA,NCAA Division I-FBS,Basketball,6008,8877,14885,15,36,175201,2628017,61264,2205511,4833528,16055194,9796088,25851282,16055194,9796088,25851282
2022,219709,Belmont University,TN,NCAA,NCAA Division I-without football,Basketball,2347,4740,7087,15,12,42575,638621,45470,545644,1184265,3635804,2508253,6144057,3635804,2508253,6144057
2022,196079,Binghamton University,NY,NCAA,NCAA Division I-without football,Basketball,6644,7436,14080,12,16,22455,269464,14435,230966,500430,2131644,1897941,4029585,2131644,1897941,4029585
2022,142115,Boise State University,ID,NCAA,NCAA Division I-FBS,Basketball,5808,7594,13402,16,24,64381,1030089,25754,618093,1648182,4719560,2786092,7505652,4823977,2786092,7610069
2022,164924,Boston College,MA,NCAA,NCAA Division I-FBS,Basketball,4508,5085,9593,16,13,175316,2805057,125555,1632210,4437267,10074076,979620,11053696,10158576,5229251,15387827
2022,164988,Boston University,MA,NCAA,NCAA Division I-without football,Basketball,7245,10170,17415,17,12,26626,452649,23221,278652,731301,3017607,2034385,5051992,3017607,2034385,5051992
2022,201441,Bowling Green State University-Main Campus,OH,NCAA,NCAA Division I-FBS,Basketball,4887,6609,11496,15,15,38275,574124,33014,495214,1069338,3266592,1507593,4774185,3266592,1507593,4774185
2022,230038,Brigham Young University,UT,NCAA,NCAA Division I-FBS,Basketball,13555,14699,28254,18,19,171123,3080217,62309,1183869,4264086,16602330,1024236,17626566,10685023,3761449,14446472
2022,217156,Brown University,RI,NCAA,NCAA Division I-FCS,Basketball,3532,3634,7166,15,20,28076,421133,16924,338480,759613,1498059,1084229,2582288,1498059,1084229,2582288
2022,110361,California Baptist University,CA,NCAA,NCAA Division I-without football,Basketball,2674,4554,7228,17,14,34909,593459,28939,405144,998603,4308059,2403510,6711569,3904277,2327263,6231540
2022,110422,California Polytechnic State University-San Luis Obispo,CA,NCAA,NCAA Division I-FCS,Basketball,10121,9823,19944,17,20,26543,451230,15724,314487,765717,2299883,1963160,4263043,2299883,1963160,4263043
2022,110486,California State University-Bakersfield,CA,NCAA,NCAA Division I-without football,Basketball,2228,4393,6621,13,14,42020,546256,20921,292894,839150,2835333,1614721,4450054,2427949,1512982,3940931
2022,110556,California State University-Fresno,CA,NCAA,NCAA Division I-FBS,Basketball,7006,10551,17557,15,25,53341,800119,21203,530084,1330203,3818506,2606192,6424698,3818506,2606192,6424698
2022,110565,California State University-Fullerton,CA,NCAA,NCAA Division I-without football,Basketball,11543,16240,27783,16,14,26571,425142,19752,276527,701669,2113578,1341226,3454804,2113578,1341226,3454804
2022,110583,California State University-Long Beach,CA,NCAA,NCAA Division I-without football,Basketball,11277,16322,27599,15,16,31753,476294,30579,489256,965550,2507334,2091552,4598886,2507334,2091552,4598886
2022,110608,California State University-Northridge,CA,NCAA,NCAA Division I-without football,Basketball,11699,14437,26136,19,18,27623,524843,18820,338757,863600,2453913,1636734,4090647,2613273,1687859,4301132
2022,110617,California State University-Sacramento,CA,NCAA,NCAA Division I-FCS,Basketball,9622,12935,22557,14,14,33322,466501,27816,389425,855926,2359870,1843195,4203065,2359870,1843195,4203065
2022,128771,Central Connecticut State University,CT,NCAA,NCAA Division I-FCS,Basketball,3338,2738,6076,15,14,11141,167113,8325,116554,283667,1184265,1109786,2294051,1184265,1109786,2294051
2022,169248,Central Michigan University,MI,NCAA,NCAA Division I-FBS,Basketball,3549,5376,8925,16,14,31553,504846,23878,334291,839137,2409265,2148544,4557809,2409265,2148544,4557809
2022,217882,Clemson University,SC,NCAA,NCAA Division I-FBS,Basketball,10225,11489,21714,16,14,92663,1482610,75814,1061396,2544006,8587001,4869129,13456130,8587001,4869129,13456130
2022,202134,Cleveland State University,OH,NCAA,NCAA Division I-without football,Basketball,3578,4204,7782,14,13,34343,480807,32430,421585,902392,2624527,1738740,4363267,2658162,1733740,4391902
2022,218724,Coastal Carolina University,SC,NCAA,NCAA Division I-FBS,Basketball,3997,4992,8989,14,14,34188,478626,25053,350735,829361,2304252,1955765,4260017,2304252,1955765,4260017
2022,217819,College of Charleston,SC,NCAA,NCAA Division I-without football,Basketball,2941,6207,9148,19,18,59930,1138668,18727,337084,1475752,4267728,2007210,6274938,4267728,2007210,6274938
2022,126818,Colorado State University-Fort Collins,CO,NCAA,NCAA Division I-FBS,Basketball,10010,12193,22203,16,16,87013,1392211,62776,1004414,2396625,5948014,3375789,9323803,5948014,3375789,9323803
2022,190150,Columbia University in the City of New York,NY,NCAA,NCAA Division I-FCS,Basketball,4218,4045,8263,15,15,21975,329632,35498,532472,862104,1508200,1876368,3384568,1508200,1876368,3384568
2022,190415,Cornell University,NY,NCAA,NCAA Division I-FCS,Basketball,7105,8522,15627,19,18,12402,235632,10204,183672,419304,1304541,1062103,2366644,1304541,1062103,2366644
2022,144740,DePaul University,IL,NCAA,NCAA Division I-without football,Basketball,5733,7126,12859,15,15,142984,2144766,72961,1094421,3239187,10540660,4411467,14952127,9404886,4411467,13816353
2022,212054,Drexel University,PA,NCAA,NCAA Division I-without football,Basketball,6682,6172,12854,15,28,50111,751670,23529,658825,1410495,3173839,2866093,6039932,3173839,2866093,6039932
2022,198419,Duke University,NC,NCAA,NCAA Division I-FBS,Basketball,3114,3429,6543,14,15,289841,4057779,105036,1575538,5633317,43918436,5266861,49185297,21404045,8167677,29571722
2022,212106,Duquesne University,PA,NCAA,NCAA Division I-FCS,Basketball,1830,3186,5016,18,15,81385,1464921,29571,443569,1908490,5653680,2604391,8258071,5653680,2604391,8258071
2022,198464,East Carolina University,NC,NCAA,NCAA Division I-FBS,Basketball,7515,10070,17585,16,15,68804,1100866,49552,743273,1844139,4406802,2659948,7066750,4396277,2648010,7044287
2022,220075,East Tennessee State University,TN,NCAA,NCAA Division I-FCS,Basketball,3319,5132,8451,16,14,19549,312789,17464,244492,557281,2159945,1716784,3876729,2159945,1716784,3876729
2022,156620,Eastern Kentucky University,KY,NCAA,NCAA Division I-FCS,Basketball,3784,5726,9510,16,15,34100,545607,14108,211621,757228,2201105,1256549,3457654,2201105,1256549,3457654
2022,169798,Eastern Michigan University,MI,NCAA,NCAA Division I-FBS,Basketball,3208,4957,8165,16,17,26976,431623,18949,322131,753754,2312257,1710986,4023243,2312257,1710986,4023243
2022,235097,Eastern Washington University,WA,NCAA,NCAA Division I-FCS,Basketball,2687,3563,6250,15,17,35444,531658,17093,290587,822245,1864478,1459657,3324135,1864478,1459657,3324135
2022,198516,Elon University,NC,NCAA,NCAA Division I-FCS,Basketball,2476,3668,6144,14,19,42743,598407,22340,424467,1022874,2691795,2140705,4832500,2691795,2140705,4832500
2022,133650,Florida Agricultural and Mechanical University,FL,NCAA,NCAA Division I-FCS,Basketball,2235,4377,6612,20,13,20414,408270,20676,268789,677059,1304563,1235436,2539999,1304563,1235436,2539999
2022,133669,Florida Atlantic University,FL,NCAA,NCAA Division I-FBS,Basketball,6532,9080,15612,15,20,67694,1015404,29461,589215,1604619,4092094,2125857,6217951,4092094,2125857,6217951
2022,433660,Florida Gulf Coast University,FL,NCAA,NCAA Division I-without football,Basketball,4768,6297,11065,17,15,30139,512360,24276,364142,876502,2264441,2175089,4439530,2264441,2175089,4439530
2022,133951,Florida International University,FL,NCAA,NCAA Division I-FBS,Basketball,10667,14555,25222,15,12,36503,547547,32223,386681,934228,2714624,1475155,4189779,2714624,1475155,4189779
2022,134097,Florida State University,FL,NCAA,NCAA Division I-FBS,Basketball,12447,17028,29475,20,10,142037,2840733,215445,2154452,4995185,19065253,5707039,24772292,13990511,5707039,19697550
2022,191241,Fordham University,NY,NCAA,NCAA Division I-FCS,Basketball,3803,5810,9613,17,25,110525,1878929,38802,970062,2848991,7996715,4135372,12132087,7996715,4135372,12132087
2022,232186,George Mason University,VA,NCAA,NCAA Division I-without football,Basketball,10783,10584,21367,15,15,93774,1406609,55387,830799,2237408,5232391,2994302,8226693,5232391,2994302,8226693
2022,131469,George Washington University,DC,NCAA,NCAA Division I-without football,Basketball,3781,6444,10225,14,21,68077,953081,34635,727336,1680417,4916917,3627748,8544665,4916917,3627748,8544665
2022,131496,Georgetown University,DC,NCAA,NCAA Division I-FCS,Basketball,2995,4153,7148,14,17,293343,4106804,51772,880116,4986920,34422346,4614226,39036572,34324430,3505311,37829741
2022,139755,Georgia Institute of Technology-Main Campus,GA,NCAA,NCAA Division I-FBS,Basketball,9684,6426,16110,16,30,167129,2674065,55417,1662499,4336564,13357762,813281,14171043,8862986,5309473,14172459
2022,139931,Georgia Southern University,GA,NCAA,NCAA Division I-FBS,Basketball,7602,10205,17807,15,16,36751,551263,22862,365793,917056,1961403,1388654,3350057,1961403,1388654,3350057
2022,139940,Georgia State University,GA,NCAA,NCAA Division I-FBS,Basketball,8690,12854,21544,16,15,48276,772420,34564,518459,1290879,2781625,1937829,4719454,2781625,1937829,4719454
2022,166027,Harvard University,MA,NCAA,NCAA Division I-FCS,Basketball,3555,3848,7403,17,15,21990,373834,15797,236953,610787,1501742,1286316,2788058,1501742,1286316,2788058
2022,191649,Hofstra University,NY,NCAA,NCAA Division I-without football,Basketball,2490,3328,5818,15,13,45945,689170,24123,313604,1002774,4174081,2557466,6731547,4174081,2557466,6731547
2022,131520,Howard University,DC,NCAA,NCAA Division I-FCS,Basketball,2449,6570,9019,18,16,10564,190157,7193,115088,305245,1440644,1397291,2837935,1440644,1397291,2837935
2022,142276,Idaho State University,ID,NCAA,NCAA Division I-FCS,Basketball,2125,3208,5333,17,29,22826,388049,11106,322061,710110,1335708,1480647,2816355,1335708,1480647,2816355
2022,145813,Illinois State University,IL,NCAA,NCAA Division I-FCS,Basketball,7298,9655,16953,15,15,44296,664436,27651,414761,1079197,2754797,1793105,4547902,2754797,1793105,4547902
2022,151324,Indiana State University,IN,NCAA,NCAA Division I-FCS,Basketball,2479,3259,5738,16,14,46616,745862,21703,303844,1049706,2545679,1488287,4033966,2545679,1488287,4033966
2022,151351,Indiana University-Bloomington,IN,NCAA,NCAA Division I-FBS,Basketball,17336,17201,34537,17,31,303700,5162897,82135,2546194,7709091,26940285,7265369,34205654,16804251,7265369,24069620
2022,151111,Indiana University-Purdue University-Indianapolis,IN,NCAA,NCAA Division I-without football,Basketball,5937,8987,14924,20,13,19913,398269,14678,190808,589077,2493470,1459211,3952681,2493470,1459211,3952681
2022,153603,Iowa State University,IA,NCAA,NCAA Division I-FBS,Basketball,13263,10668,23931,13,15,157278,2044617,121054,1815815,3860432,16120049,881254,17001303,8326965,5271866,13598831
2022,101480,Jacksonville State University,AL,NCAA,NCAA Division I-FCS,Basketball,2529,3784,6313,15,15,33313,499699,18933,283998,783697,1967554,1289566,3257120,1967554,1289566,3257120
2022,232423,James Madison University,VA,NCAA,NCAA Division I-FCS,Basketball,8075,10848,18923,17,30,59387,1009584,30292,908763,1918347,3900522,3570013,7470535,3900522,3570013,7470535
2022,155399,Kansas State University,KS,NCAA,NCAA Division I-FBS,Basketball,6790,6629,13419,15,35,174630,2619454,45605,1596170,4215624,11461173,377677,11838850,9310785,4499636,13810421
2022,486840,Kennesaw State University,GA,NCAA,NCAA Division I-FCS,Basketball,14171,14383,28554,16,21,35988,575809,14143,297010,872819,2538955,1666849,4205804,2538955,1666849,4205804
2022,203517,Kent State University at Kent,OH,NCAA,NCAA Division I-FBS,Basketball,6185,10484,16669,20,19,30821,616419,10410,197795,814214,2433919,1374484,3808403,2433919,1374484,3808403
2022,226091,Lamar University,TX,NCAA,NCAA Division I-FCS,Basketball,2474,3681,6155,16,14,15992,255871,17828,249595,505466,1575969,1236796,2812765,1575969,1236796,2812765
2022,213543,Lehigh University,PA,NCAA,NCAA Division I-FCS,Basketball,2998,2552,5550,17,14,18468,313960,17640,246966,560926,2105777,1896155,4001932,2105777,1896155,4001932
2022,232557,Liberty University,VA,NCAA,NCAA Division I-FBS,Basketball,13116,17872,30988,16,15,69897,1118356,43461,651909,1770265,5080657,2398047,7478704,5080657,2398047,7478704
2022,192448,Long Island University,NY,NCAA,NCAA Division I-FCS,Basketball,1795,3430,5225,16,17,25186,402982,19038,323654,726636,3229313,1967650,5196963,3229313,1967650,5196963
2022,159391,Louisiana State University and Agricultural & Mechanical College,LA,NCAA,NCAA Division I-FBS,Basketball,11846,14550,26396,17,15,105755,1797829,119698,1795469,3593298,12031865,2486618,14518483,10687801,10251412,20939213
2022,159647,Louisiana Tech University,LA,NCAA,NCAA Division I-FBS,Basketball,3984,2965,6949,14,15,48643,681004,31513,472691,1153695,2608492,1941602,4550094,2608492,1941602,4550094
2022,117946,Loyola Marymount University,CA,NCAA,NCAA Division I-without football,Basketball,3267,3725,6992,16,14,135742,2171864,58769,822770,2994634,7269326,3686168,10955494,7269326,3686168,10955494
2022,146719,Loyola University Chicago,IL,NCAA,NCAA Division I-without football,Basketball,3447,7698,11145,16,13,91252,1460026,57852,752070,2212096,5274226,2723424,7997650,5274226,2723424,7997650
2022,239105,Marquette University,WI,NCAA,NCAA Division I-without football,Basketball,3150,4010,7160,18,29,272721,4908977,61666,1788314,6697291,20723046,4814091,25537137,17268167,4814091,22082258
2022,237525,Marshall University,WV,NCAA,NCAA Division I-FBS,Basketball,2679,3625,6304,14,17,73266,1025728,42669,725368,1751096,3884753,2096807,5981560,3884753,2096807,5981560
2022,204024,Miami University-Oxford,OH,NCAA,NCAA Division I-FBS,Basketball,7875,8527,16402,15,26,31372,470574,13263,344843,815417,2437764,1820631,4258395,2437764,1820631,4258395
2022,171100,Michigan State University,MI,NCAA,NCAA Division I-FBS,Basketball,17203,18669,35872,14,17,177365,2483111,74304,1263164,3746275,20524534,6371711,26896245,16395751,6371711,22767462
2022,220978,Middle Tennessee State University,TN,NCAA,NCAA Division I-FBS,Basketball,6559,7285,13844,15,14,61137,917049,60243,843400,1760449,3137205,2755393,5892598,3137205,2755393,5892598
2022,176080,Mississippi State University,MS,NCAA,NCAA Division I-FBS,Basketball,8140,8441,16581,17,15,103941,1767002,109578,1643667,3410669,9319188,6140522,15459710,9319188,6140522,15459710
2022,179566,Missouri State University-Springfield,MO,NCAA,NCAA Division I-FCS,Basketball,4352,6898,11250,17,20,58224,989802,32200,643990,1633792,3209480,2164834,5374314,3209480,2164834,5374314
2022,180461,Montana State University,MT,NCAA,NCAA Division I-FCS,Basketball,6650,5815,12465,14,16,42865,600115,28077,449237,1049352,2453139,1726372,4179511,2887114,2051113,4938227
2022,163453,Morgan State University,MD,NCAA,NCAA Division I-FCS,Basketball,2608,4398,7006,16,15,41458,663326,29764,446454,1109780,2426960,1564017,3990977,1982520,1514467,3496987
2022,157401,Murray State University,KY,NCAA,NCAA Division I-FCS,Basketball,2233,3565,5798,14,16,42960,601442,23275,372400,973842,4306180,1527348,5833528,2823064,1348545,4171609
2022,185828,New Jersey Institute of Technology,NJ,NCAA,NCAA Division I-without football,Basketball,5393,1989,7382,14,16,20363,285081,12995,207926,493007,2297939,1796486,4094425,2297939,1787414,4085353
2022,188030,New Mexico State University-Main Campus,NM,NCAA,NCAA Division I-FBS,Basketball,3874,5448,9322,19,18,40960,778241,30428,547696,1325937,3180322,2013722,5194044,3180322,2013722,5194044
2022,199102,North Carolina A & T State University,NC,NCAA,NCAA Division I-FCS,Basketball,3770,6693,10463,17,15,33253,565296,30407,456104,1021400,1565988,1434906,3000894,1566280,1445954,3012234
2022,199193,North Carolina State University at Raleigh,NC,NCAA,NCAA Division I-FBS,Basketball,11800,11845,23645,15,11,135049,2025729,124725,1371973,3397702,18662255,1094870,19757125,10511126,4928097,15439223
2022,200332,North Dakota State University-Main Campus,ND,NCAA,NCAA Division I-FCS,Basketball,4473,4429,8902,13,14,40866,531258,41157,576194,1107452,1765843,1714139,3479982,1765843,1714139,3479982
2022,167358,Northeastern University,MA,NCAA,NCAA Division I-without football,Basketball,7100,9072,16172,13,16,55475,721176,25854,413660,1134836,3733297,2785868,6519165,3733297,2785868,6519165
2022,105330,Northern Arizona University,AZ,NCAA,NCAA Division I-FCS,Basketball,7503,12507,20010,17,12,27155,461641,49702,596423,1058064,1706778,1636207,3342985,1706778,1636207,3342985
2022,147703,Northern Illinois University,IL,NCAA,NCAA Division I-FBS,Basketball,4647,5278,9925,14,15,25521,357300,26225,393371,750671,1249270,1465901,2715171,1249270,1465901,2715171
2022,157447,Northern Kentucky University,KY,NCAA,NCAA Division I-without football,Basketball,2958,4162,7120,16,16,40732,651710,22614,361827,1013537,2537322,1493480,4030802,2537322,1493480,4030802
2022,147767,Northwestern University,IL,NCAA,NCAA Division I-FBS,Basketball,3978,4610,8588,13,15,157102,2042320,96187,1442798,3485118,14053987,1656934,15710921,12431297,5854676,18285973
2022,171571,Oakland University,MI,NCAA,NCAA Division I-without football,Basketball,4217,6004,10221,15,24,44349,665242,13579,325900,991142,2346417,1431251,3777668,2346417,1431251,3777668
2022,204796,Ohio State University-Main Campus,OH,NCAA,NCAA Division I-FBS,Basketball,20955,21231,42186,14,14,210927,2952976,142261,1991654,4944630,23638698,1277839,24916537,13062023,6565977,19628000
2022,204857,Ohio University-Main Campus,OH,NCAA,NCAA Division I-FBS,Basketball,6262,8346,14608,15,14,49767,746506,20830,291626,1038132,3513702,1829481,5343183,3513702,1829481,5343183
2022,207388,Oklahoma State University-Main Campus,OK,NCAA,NCAA Division I-FBS,Basketball,8740,9480,18220,15,25,167388,2510825,61823,1545586,4056411,14991097,1032938,16024035,9607887,4669466,14277353
2022,232982,Old Dominion University,VA,NCAA,NCAA Division I-FBS,Basketball,6267,7601,13868,15,14,71300,1069504,72386,1013406,2082910,3741903,3085169,6827072,3741903,3085169,6827072
2022,209542,Oregon State University,OR,NCAA,NCAA Division I-FBS,Basketball,10119,9588,19707,15,31,104294,1564412,38241,1185480,2749892,7838931,4673877,12512808,7085122,4673877,11758999
2022,214777,Pennsylvania State University-Main Campus,PA,NCAA,NCAA Division I-FBS,Basketball,21343,19132,40475,16,14,138753,2220047,115945,1623225,3843272,16583320,1102841,17686161,13059514,5021216,18080730
2022,209807,Portland State University,OR,NCAA,NCAA Division I-FCS,Basketball,4641,6326,10967,14,15,32471,454600,20159,302387,756987,1956434,1469920,3426354,1956434,1469920,3426354
2022,227526,Prairie View A & M University,TX,NCAA,NCAA Division I-FCS,Basketball,2266,4897,7163,16,15,31443,503089,25828,387418,890507,1259630,1089298,2348928,1259630,1089298,2348928
2022,186131,Princeton University,NJ,NCAA,NCAA Division I-FCS,Basketball,2762,2765,5527,17,15,44542,757215,32424,486361,1243576,2172036,1452306,3624342,2172036,1452306,3624342
2022,243780,Purdue University-Main Campus,IN,NCAA,NCAA Division I-FBS,Basketball,21058,15417,36475,16,13,183327,2933235,115226,1497936,4431171,16311833,6931516,23243349,10494940,4206194,14701134
2022,130226,Quinnipiac University,CT,NCAA,NCAA Division I-without football,Basketball,2240,3606,5846,14,15,8211,114958,6499,97489,212447,2837501,2417250,5254751,2837501,2417250,5254751
2022,233277,Radford University,VA,NCAA,NCAA Division I-without football,Basketball,2067,3411,5478,16,15,25551,408814,13716,205738,614552,1913286,1315098,3228384,1913286,1315098,3228384
2022,186380,Rutgers University-New Brunswick,NJ,NCAA,NCAA Division I-FBS,Basketball,17318,17312,34630,16,22,166881,2670098,90107,1982343,4652441,13483073,7807108,21290181,13483073,7807108,21290181
2022,130253,Sacred Heart University,CT,NCAA,NCAA Division I-FCS,Basketball,2091,4186,6277,14,16,20409,285726,24405,390481,676207,1749823,1877015,3626838,1749823,1877015,3626838
2022,179159,Saint Louis University,MO,NCAA,NCAA Division I-without football,Basketball,2564,4115,6679,16,18,105030,1680484,52495,944902,2625386,7959854,3433542,11393396,7959854,3433542,11393396
2022,227881,Sam Houston State University,TX,NCAA,NCAA Division I-FCS,Basketball,5306,9267,14573,15,13,36598,548975,31874,414361,963336,1844534,1407759,3252293,1844534,1407759,3252293
2022,122409,San Diego State University,CA,NCAA,NCAA Division I-FBS,Basketball,11992,16456,28448,17,23,255074,4336256,61703,1419160,5755416,14133695,2254235,16387930,9114263,3119460,12233723
2022,122755,San Jose State University,CA,NCAA,NCAA Division I-FBS,Basketball,11175,10351,21526,13,15,61800,803406,25224,378365,1181771,3254424,2152244,5406668,3254424,2152244,5406668
2022,122931,Santa Clara University,CA,NCAA,NCAA Division I-without football,Basketball,3079,2910,5989,15,14,119413,1791192,42161,590247,2381439,5726589,2826415,8553004,5726589,2826415,8553004
2022,186584,Seton Hall University,NJ,NCAA,NCAA Division I-without football,Basketball,2551,3183,5734,16,13,126326,2021212,87494,1137416,3158628,8607797,3726920,12334717,8607796,3726920,12334716
2022,219356,South Dakota State University,SD,NCAA,NCAA Division I-FCS,Basketball,3562,4020,7582,13,15,62934,818145,39040,585597,1403742,2193628,1841981,4035609,2193628,1841981,4035609
2022,179557,Southeast Missouri State University,MO,NCAA,NCAA Division I-FCS,Basketball,2486,3716,6202,15,15,17647,264710,11689,175328,440038,1529076,1064316,2593392,1529076,1064316,2593392
2022,160612,Southeastern Louisiana University,LA,NCAA,NCAA Division I-FCS,Basketball,2911,4796,7707,15,15,18948,284226,17270,259044,543270,1142611,1008234,2150845,1142611,1008234,2150845
2022,149222,Southern Illinois University-Carbondale,IL,NCAA,NCAA Division I-FCS,Basketball,3248,3448,6696,15,14,32883,493239,21156,296183,789422,2573107,1444648,4017755,2573107,1444648,4017755
2022,149231,Southern Illinois University-Edwardsville,IL,NCAA,NCAA Division I-without football,Basketball,3301,4392,7693,15,16,19752,296287,30006,480093,776380,1415268,1527375,2942643,1415268,1527375,2942643
2022,228246,Southern Methodist University,TX,NCAA,NCAA Division I-FBS,Basketball,3383,3497,6880,16,15,104483,1671728,68107,1021611,2693339,10618903,4273266,14892169,10618903,4273267,14892170
2022,160621,Southern University and A & M College,LA,NCAA,NCAA Division I-FCS,Basketball,1679,3396,5075,14,17,28239,395352,21455,364729,760081,688583,491983,1180566,1023075,935927,1959002
2022,230603,Southern Utah University,UT,NCAA,NCAA Division I-FCS,Basketball,3331,4489,7820,18,14,25994,467900,29900,418595,886495,1508533,1250022,2758555,1566836,1311330,2878166
2022,195809,St. John's University-New York,NY,NCAA,NCAA Division I-without football,Basketball,4412,5438,9850,17,18,132167,2246846,55997,1007943,3254789,12034922,3935032,15969954,12034922,3935032,15969954
2022,243744,Stanford University,CA,NCAA,NCAA Division I-FBS,Basketball,3744,4017,7761,14,17,113657,1591192,89428,1520280,3111472,8122603,8111552,16234155,8122603,8111552,16234155
2022,228431,Stephen F Austin State University,TX,NCAA,NCAA Division I-FCS,Basketball,2871,4961,7832,15,13,52796,791940,47353,615590,1407530,3203671,2299525,5503196,3203671,2299525,5503196
2022,196097,Stony Brook University,NY,NCAA,NCAA Division I-FCS,Basketball,7988,8326,16314,14,13,59476,832662,30177,392298,1224960,3282312,2070398,5352710,3282312,2070398,5352710
2022,196060,SUNY at Albany,NY,NCAA,NCAA Division I-FCS,Basketball,5240,6295,11535,13,14,32751,425761,19428,271994,697755,2254828,1719885,3974713,2020013,1665800,3685813
2022,196413,Syracuse University,NY,NCAA,NCAA Division I-FBS,Basketball,6620,7981,14601,17,14,143536,2440113,119742,1676381,4116494,32350259,2315607,34665866,21376616,5798511,27175127
2022,228529,Tarleton State University,TX,NCAA,NCAA Division I-FCS,Basketball,3128,5617,8745,35,41,16999,594976,10541,432178,1027154,1790628,1458836,3249464,1659163,1566530,3225693
2022,216339,Temple University,PA,NCAA,NCAA Division I-FBS,Basketball,9531,12387,21918,15,14,98971,1484562,61672,863407,2347969,8606016,4595454,13201470,8606016,4595454,13201470
2022,221838,Tennessee State University,TN,NCAA,NCAA Division I-FCS,Basketball,2256,4424,6680,15,15,23412,351185,15349,230238,581423,1693147,1239842,2932989,1693147,1239842,2932989
2022,221847,Tennessee Technological University,TN,NCAA,NCAA Division I-FCS,Basketball,4206,3508,7714,17,14,17741,301592,25084,351180,652772,1573261,1440693,3013954,1573261,1440693,3013954
2022,228723,Texas A & M University-College Station,TX,NCAA,NCAA Division I-FBS,Basketball,26902,24141,51043,18,13,186586,3358549,141979,1845721,5204270,12899246,901482,13800728,13792475,6973529,20766004
2022,224554,Texas A & M University-Commerce,TX,NCAA,NCAA Division I-FCS,Basketball,2108,3216,5324,14,16,28057,392803,16755,268076,660879,1716524,1420572,3137096,1690213,1384648,3074861
2022,224147,Texas A & M University-Corpus Christi,TX,NCAA,NCAA Division I-without football,Basketball,2360,3652,6012,16,24,40483,647721,19457,466957,1114678,2401821,1734409,4136230,2401821,1734409,4136230
2022,228875,Texas Christian University,TX,NCAA,NCAA Division I-FBS,Basketball,3939,6387,10326,18,29,143559,2584055,51257,1486464,4070519,14094198,6686246,20780444,14576029,8083091,22659120
2022,229063,Texas Southern University,TX,NCAA,NCAA Division I-FCS,Basketball,1967,3717,5684,13,17,8738,113597,4261,72445,186042,2007659,1126308,3133967,1923581,1201768,3125349
2022,228459,Texas State University,TX,NCAA,NCAA Division I-FBS,Basketball,10984,16775,27759,14,14,49045,686634,38453,538343,1224977,2473989,1901271,4375260,2473989,1901271,4375260
2022,229115,Texas Tech University,TX,NCAA,NCAA Division I-FBS,Basketball,14705,14370,29075,14,14,207220,2901079,129136,1807897,4708976,14477595,2294076,16771671,16173338,5388320,21561658
2022,100751,The University of Alabama,AL,NCAA,NCAA Division I-FBS,Basketball,12721,16165,28886,17,34,174796,2971538,27705,941965,3913503,20592916,4803959,25396875,12834918,4803959,17638877
2022,180489,The University of Montana,MT,NCAA,NCAA Division I-FCS,Basketball,2429,3352,5781,16,14,11800,188805,11047,154653,343458,1727892,1695994,3423886,2613960,1695994,4309954
2022,221740,The University of Tennessee-Chattanooga,TN,NCAA,NCAA Division I-FCS,Basketball,3687,5192,8879,14,12,33606,470484,20863,250355,720839,1920140,1596654,3516794,1920140,1596654,3516794
2022,221759,The University of Tennessee-Knoxville,TN,NCAA,NCAA Division I-FBS,Basketball,11679,14119,25798,18,34,206279,3713022,73853,2511002,6224024,19097170,3237076,22334246,15619680,7538346,23158026
2022,228769,The University of Texas at Arlington,TX,NCAA,NCAA Division I-without football,Basketball,8341,10526,18867,15,15,33271,499071,33129,496931,996002,2450008,2016281,4466289,2450008,2016281,4466289
2022,228778,The University of Texas at Austin,TX,NCAA,NCAA Division I-FBS,Basketball,16167,22277,38444,14,28,174106,2437483,64908,1817436,4254919,22629647,2614231,25243878,16092106,10047120,26139226
2022,228796,The University of Texas at El Paso,TX,NCAA,NCAA Division I-FBS,Basketball,6053,7622,13675,17,16,40979,696638,28265,452238,1148876,6049132,1409913,7459045,4012116,1959553,5971669
2022,229027,The University of Texas at San Antonio,TX,NCAA,NCAA Division I-FBS,Basketball,10077,11661,21738,15,20,40113,601693,25689,513780,1115473,2681468,2270138,4951606,2681468,2270138,4951606
2022,227368,The University of Texas Rio Grande Valley,TX,NCAA,NCAA Division I-without football,Basketball,7778,11878,19656,16,16,33045,528715,28613,457810,986525,1973230,1487022,3460252,1973230,1487022,3460252
2022,164076,Towson University,MD,NCAA,NCAA Division I-FCS,Basketball,6047,8722,14769,16,13,36748,587964,36305,471966,1059930,2478685,1869415,4348100,2478685,1869415,4348100
2022,102368,Troy University,AL,NCAA,NCAA Division I-FBS,Basketball,2498,4571,7069,18,16,18966,341391,14804,236869,578260,1864926,1580607,3445533,1773986,1522070,3296056
2022,160755,Tulane University of Louisiana,LA,NCAA,NCAA Division I-FBS,Basketball,3104,4977,8081,16,13,89582,1433311,57561,748295,2181606,5390610,1865536,7256146,5949218,4111350,10060568
2022,196088,University at Buffalo,NY,NCAA,NCAA Division I-FBS,Basketball,10360,8686,19046,14,12,61237,857311,34525,414298,1271609,3830991,1701595,5532586,3830991,1701595,5532586
2022,200800,University of Akron Main Campus,OH,NCAA,NCAA Division I-FBS,Basketball,4498,4019,8517,15,19,48476,727133,17529,333042,1060175,3324785,1659382,4984167,3324785,1659382,4984167
2022,100663,University of Alabama at Birmingham,AL,NCAA,NCAA Division I-FBS,Basketball,3822,6417,10239,15,17,81483,1222250,32877,558908,1781158,5512768,2378869,7891637,5160789,2231178,7391967
2022,104179,University of Arizona,AZ,NCAA,NCAA Division I-FBS,Basketball,13006,17130,30136,19,12,252012,4788227,111753,1341039,6129266,26326675,2016027,28342702,15934003,5882695,21816698
2022,106397,University of Arkansas,AR,NCAA,NCAA Division I-FBS,Basketball,10440,12955,23395,15,14,252749,3791240,130423,1825926,5617166,19431939,383299,19815238,13804715,5596941,19401656
2022,110635,University of California-Berkeley,CA,NCAA,NCAA Division I-FBS,Basketball,13635,17185,30820,15,30,130023,1950350,46895,1406853,3357203,9070947,5035689,14106636,9071947,5035689,14107636
2022,110644,University of California-Davis,CA,NCAA,NCAA Division I-FCS,Basketball,12305,18349,30654,15,24,30982,464728,14249,341965,806693,2823059,2113297,4936356,2823059,2113297,4936356
2022,110653,University of California-Irvine,CA,NCAA,NCAA Division I-without football,Basketball,12209,15712,27921,16,14,51454,823262,31865,446111,1269373,3536202,2201760,5737962,3536202,2201760,5737962
2022,110662,University of California-Los Angeles,CA,NCAA,NCAA Division I-FBS,Basketball,12533,19230,31763,16,25,163400,2614403,61280,1531988,4146391,14666248,7016096,21682344,13825844,7016096,20841940
2022,110671,University of California-Riverside,CA,NCAA,NCAA Division I-without football,Basketball,10531,11423,21954,15,15,38823,582342,23796,356946,939288,2640169,2001237,4641406,2371151,2001237,4372388
2022,110705,University of California-Santa Barbara,CA,NCAA,NCAA Division I-without football,Basketball,10006,12787,22793,17,14,32863,558675,26558,371811,930486,4045142,2110532,6155674,4045142,2110532,6155674
2022,106704,University of Central Arkansas,AR,NCAA,NCAA Division I-FCS,Basketball,2538,4082,6620,17,13,24655,419134,16536,214969,634103,1339958,1000428,2340386,1339958,1000428,2340386
2022,132903,University of Central Florida,FL,NCAA,NCAA Division I-FBS,Basketball,18195,22324,40519,16,16,89945,1439117,55498,887973,2327090,6034003,3787635,9821638,6034003,3787635,9821638
2022,201885,University of Cincinnati-Main Campus,OH,NCAA,NCAA Division I-FBS,Basketball,12694,12171,24865,15,15,203925,3058869,66789,1001829,4060698,9011526,3630317,12641843,9011526,3630317,12641843
2022,126614,University of Colorado Boulder,CO,NCAA,NCAA Division I-FBS,Basketball,15337,13317,28654,18,28,78883,1419889,48982,1371491,2791380,9459880,1144678,10604558,8200758,5034934,13235692
2022,129020,University of Connecticut,CT,NCAA,NCAA Division I-FBS,Basketball,8591,9728,18319,16,12,286210,4579358,245513,2946157,7525515,13100942,9977779,23078721,13100942,9977779,23078721
2022,202480,University of Dayton,OH,NCAA,NCAA Division I-FCS,Basketball,4218,3872,8090,16,11,154436,2470977,88768,976444,3447421,17760511,1424208,19184719,9381496,3665842,13047338
2022,130943,University of Delaware,DE,NCAA,NCAA Division I-FCS,Basketball,7375,10647,18022,17,25,36766,625017,15266,381641,1006658,3241540,2537531,5779071,3241540,2537531,5779071
2022,127060,University of Denver,CO,NCAA,NCAA Division I-without football,Basketball,2506,3154,5660,16,14,36685,586960,28000,391993,978953,2845383,2311301,5156684,2845383,2311301,5156684
2022,134130,University of Florida,FL,NCAA,NCAA Division I-FBS,Basketball,13165,17525,30690,15,15,143921,2158820,113000,1695003,3853823,12795299,111571,12906870,8432245,5077821,13510066
2022,139959,University of Georgia,GA,NCAA,NCAA Division I-FBS,Basketball,11938,16820,28758,14,16,122279,1711906,70271,1124340,2836246,13116828,1524813,14641641,10306498,6066450,16372948
2022,141574,University of Hawaii at Manoa,HI,NCAA,NCAA Division I-FBS,Basketball,4421,6908,11329,15,16,44011,660163,40488,647808,1307971,2339181,1286866,3626047,3079142,2414310,5493452
2022,225511,University of Houston,TX,NCAA,NCAA Division I-FBS,Basketball,12597,14466,27063,13,16,151640,1971326,42889,686231,2657557,11117868,2672885,13790753,11117868,2672885,13790753
2022,142285,University of Idaho,ID,NCAA,NCAA Division I-FCS,Basketball,3309,3321,6630,15,13,37980,569706,42307,549995,1119701,1688044,1530835,3218879,1688044,1530835,3218879
2022,145600,University of Illinois Chicago,IL,NCAA,NCAA Division I-without football,Basketball,9110,10455,19565,13,15,51806,673475,25101,376522,1049997,2832829,1927618,4760447,2832829,1927618,4760447
2022,145637,University of Illinois Urbana-Champaign,IL,NCAA,NCAA Division I-FBS,Basketball,17641,15632,33273,13,13,204484,2658288,119289,1550756,4209044,28194287,1642652,29836939,14212102,6060973,20273075
2022,153658,University of Iowa,IA,NCAA,NCAA Division I-FBS,Basketball,8804,11332,20136,15,26,158038,2370577,120607,3135780,5506357,14684165,3804579,18488744,10393230,8211454,18604684
2022,155317,University of Kansas,KS,NCAA,NCAA Division I-FBS,Basketball,7796,8933,16729,17,17,202891,3449140,105522,1793866,5243006,18347052,354330,18701382,15273973,4850331,20124304
2022,157085,University of Kentucky,KY,NCAA,NCAA Division I-FBS,Basketball,8721,12023,20744,15,15,292711,4390660,98179,1472686,5863346,24152043,5621816,29773859,24152043,5621816,29773859
2022,160658,University of Louisiana at Lafayette,LA,NCAA,NCAA Division I-FBS,Basketball,4469,6077,10546,16,17,59097,945545,28576,485799,1431344,3308048,1968100,5276148,3308048,1968100,5276148
2022,157289,University of Louisville,KY,NCAA,NCAA Division I-FBS,Basketball,4963,6303,11266,15,14,178728,2680915,149062,2086871,4767786,38452776,2155945,40608721,19081734,6199356,25281090
2022,161253,University of Maine,ME,NCAA,NCAA Division I-FCS,Basketball,3885,3716,7601,18,15,22397,403139,22170,332556,735695,2049546,1580122,3629668,2049546,1580122,3629668
2022,163268,University of Maryland-Baltimore County,MD,NCAA,NCAA Division I-without football,Basketball,4863,4206,9069,17,14,29900,508308,27009,378132,886440,2423647,1917120,4340767,2423647,1917120,4340767
2022,163286,University of Maryland-College Park,MD,NCAA,NCAA Division I-FBS,Basketball,14029,13883,27912,15,13,175000,2625004,153495,1995430,4620434,15049597,1053746,16103343,12021302,7476313,19497615
2022,166629,University of Massachusetts-Amherst,MA,NCAA,NCAA Division I-FBS,Basketball,11152,11677,22829,17,39,56269,956578,25567,997101,1953679,5827846,3433239,9261085,5827846,3433239,9261085
2022,166513,University of Massachusetts-Lowell,MA,NCAA,NCAA Division I-without football,Basketball,5667,3956,9623,14,12,29003,406037,24814,297762,703799,2283748,1497773,3781521,2283748,1497773,3781521
2022,220862,University of Memphis,TN,NCAA,NCAA Division I-FBS,Basketball,4365,6547,10912,16,15,165384,2646145,120423,1806347,4452492,9757765,4060388,13818153,9757765,4060388,13818153
2022,135726,University of Miami,FL,NCAA,NCAA Division I-FBS,Basketball,5528,6312,11840,15,52,138393,2075902,30763,1599657,3675559,13991976,7912829,21904805,13991976,7912829,21904805
2022,170976,University of Michigan-Ann Arbor,MI,NCAA,NCAA Division I-FBS,Basketball,14705,16443,31148,16,30,166238,2659804,52281,1568429,4228233,20902366,912788,21815154,12018804,5494773,17513577
2022,174066,University of Minnesota-Twin Cities,MN,NCAA,NCAA Division I-FBS,Basketball,12956,15502,28458,14,22,118382,1657350,53201,1170414,2827764,17411807,767229,18179036,8615354,5776462,14391816
2022,176017,University of Mississippi,MS,NCAA,NCAA Division I-FBS,Basketball,6836,9313,16149,17,14,127101,2160724,139647,1955063,4115787,13421874,7098166,20520040,13421874,7098166,20520040
2022,178396,University of Missouri-Columbia,MO,NCAA,NCAA Division I-FBS,Basketball,9963,11990,21953,15,13,174883,2623246,100258,1303350,3926596,14852293,4341457,19193750,14178273,4341457,18519730
2022,178402,University of Missouri-Kansas City,MO,NCAA,NCAA Division I-without football,Basketball,2143,3404,5547,24,27,27565,661562,13260,358012,1019574,2822341,1981204,4803545,2822341,1789650,4611991
2022,181394,University of Nebraska at Omaha,NE,NCAA,NCAA Division I-without football,Basketball,4262,5691,9953,16,14,37952,607228,21734,304278,911506,2694850,2137455,4832305,2889971,1651244,4541215
2022,181464,University of Nebraska-Lincoln,NE,NCAA,NCAA Division I-FBS,Basketball,9015,9155,18170,18,41,123222,2217989,35156,1441410,3659399,17288897,1696981,18985878,10195829,5146780,15342609
2022,182281,University of Nevada-Las Vegas,NV,NCAA,NCAA Division I-FBS,Basketball,8407,11128,19535,15,12,47569,713534,47050,564600,1278134,4727314,2335267,7062581,4727314,2335267,7062581
2022,182290,University of Nevada-Reno,NV,NCAA,NCAA Division I-FBS,Basketball,6459,7288,13747,14,14,108067,1512936,47613,666584,2179520,5241656,2456852,7698508,5241656,2456852,7698508
2022,183044,University of New Hampshire-Main Campus,NH,NCAA,NCAA Division I-FCS,Basketball,4842,6341,11183,13,12,23171,301219,19878,238534,539753,1497649,1145877,2643526,1497649,1145877,2643526
2022,187985,University of New Mexico-Main Campus,NM,NCAA,NCAA Division I-FBS,Basketball,5034,6880,11914,15,15,54911,823661,37314,559708,1383369,5111106,2778178,7889284,4908879,2778178,7687057
2022,199120,University of North Carolina at Chapel Hill,NC,NCAA,NCAA Division I-FBS,Basketball,7532,11630,19162,18,26,248289,4469210,61534,1599877,6069087,31745487,1025627,32771114,10759922,5801731,16561653
2022,199139,University of North Carolina at Charlotte,NC,NCAA,NCAA Division I-FBS,Basketball,10321,9668,19989,15,19,72458,1086867,36115,686178,1773045,3658850,2250029,5908879,3658850,2250029,5908879
2022,199148,University of North Carolina at Greensboro,NC,NCAA,NCAA Division I-without football,Basketball,3883,7651,11534,16,15,26165,418642,16386,245795,664437,2484156,1714508,4198664,2484156,1714508,4198664
2022,199218,University of North Carolina Wilmington,NC,NCAA,NCAA Division I-without football,Basketball,4388,7321,11709,15,16,39751,596271,15578,249240,845511,2831698,1290484,4122182,2831698,1290484,4122182
2022,200280,University of North Dakota,ND,NCAA,NCAA Division I-FCS,Basketball,3641,3350,6991,14,24,36307,508300,19215,461151,969451,2144905,2040553,4185458,2144904,2040553,4185457
2022,136172,University of North Florida,FL,NCAA,NCAA Division I-without football,Basketball,4522,6228,10750,13,11,37139,482807,23258,255839,738646,1836719,1234109,3070828,1836719,1234109,3070828
2022,227216,University of North Texas,TX,NCAA,NCAA Division I-FBS,Basketball,11755,14248,26003,16,17,95345,1525521,45489,773311,2298832,4426793,2448323,6875116,4426793,2448323,6875116
2022,127741,University of Northern Colorado,CO,NCAA,NCAA Division I-FCS,Basketball,1802,3563,5365,15,22,30953,464298,18177,399896,864194,1797779,1558657,3356436,1797779,1558657,3356436
2022,154095,University of Northern Iowa,IA,NCAA,NCAA Division I-FCS,Basketball,2635,4328,6963,15,31,45797,686950,14431,447367,1134317,3311458,1466335,4777793,3296659,1466335,4762994
2022,152080,University of Notre Dame,IN,NCAA,NCAA Division I-FBS,Basketball,4568,4331,8899,13,12,233879,3040427,209519,2514226,5554653,15058993,6303431,21362424,15058993,6303431,21362424
2022,207500,University of Oklahoma-Norman Campus,OK,NCAA,NCAA Division I-FBS,Basketball,8954,9525,18479,15,23,141136,2117034,76243,1753588,3870622,14478267,3075625,17553892,12129422,6399371,18528793
2022,209551,University of Oregon,OR,NCAA,NCAA Division I-FBS,Basketball,8035,10150,18185,16,25,124596,1993531,52851,1321285,3314816,10271432,1866359,12137791,11919466,5189434,17108900
2022,215062,University of Pennsylvania,PA,NCAA,NCAA Division I-FCS,Basketball,4611,5542,10153,26,18,13866,360521,19400,349203,709724,1897675,1202581,3100256,1897675,1202581,3100256
2022,215293,University of Pittsburgh-Pittsburgh Campus,PA,NCAA,NCAA Division I-FBS,Basketball,8129,11104,19233,15,29,232763,3491452,52590,1525110,5016562,14746383,5220185,19966568,12352136,5220185,17572321
2022,217484,University of Rhode Island,RI,NCAA,NCAA Division I-FCS,Basketball,5481,7419,12900,14,14,132309,1852329,69149,968090,2820419,6414386,3296617,9711003,6464940,3338287,9803227
2022,122436,University of San Diego,CA,NCAA,NCAA Division I-FCS,Basketball,2371,3086,5457,18,17,44525,801448,30232,513939,1315387,5272864,2672491,7945355,5272864,2672491,7945355
2022,122612,University of San Francisco,CA,NCAA,NCAA Division I-without football,Basketball,2040,3753,5793,15,15,85675,1285131,54144,812164,2097295,6010817,3309971,9320788,6010817,3309971,9320788
2022,102094,University of South Alabama,AL,NCAA,NCAA Division I-FBS,Basketball,2676,4371,7047,13,15,61836,803868,14472,217080,1020948,2691430,1662812,4354242,2691430,1662812,4354242
2022,218663,University of South Carolina-Columbia,SC,NCAA,NCAA Division I-FBS,Basketball,11235,14725,25960,14,28,99535,1393484,57906,1621356,3014840,11564622,10767616,22332238,7953678,10767616,18721294
2022,137351,University of South Florida,FL,NCAA,NCAA Division I-FBS,Basketball,12671,17010,29681,15,14,106702,1600533,106640,1492957,3093490,6301950,4301377,10603327,6301950,4301377,10603327
2022,123961,University of Southern California,CA,NCAA,NCAA Division I-FBS,Basketball,9562,10495,20057,15,14,113773,1706593,75808,1061305,2767898,10943295,6096280,17039575,10943295,6096280,17039575
2022,176372,University of Southern Mississippi,MS,NCAA,NCAA Division I-FBS,Basketball,2934,5684,8618,16,20,32552,520826,20209,404185,925011,1997985,1603940,3601925,1997985,1603940,3601925
2022,174914,University of St Thomas,MN,NCAA,NCAA Division I-FCS,Basketball,2931,2776,5707,14,15,28885,404395,17931,268971,673366,1933379,1608323,3541702,1933379,1608323,3541702
2022,206084,University of Toledo,OH,NCAA,NCAA Division I-FBS,Basketball,4708,4866,9574,14,30,25630,358814,9939,298167,656981,2806550,2460452,5267002,2806550,2460452,5267002
2022,230764,University of Utah,UT,NCAA,NCAA Division I-FBS,Basketball,10979,10210,21189,16,13,91634,1466136,66992,870901,2337037,15036488,748165,15784653,11803281,4383158,16186439
2022,231174,University of Vermont,VT,NCAA,NCAA Division I-without football,Basketball,3986,7075,11061,15,15,41148,617219,28312,424687,1041906,2822203,2004160,4826363,2822278,2004568,4826846
2022,234076,University of Virginia-Main Campus,VA,NCAA,NCAA Division I-FBS,Basketball,7189,9263,16452,16,34,124500,1992007,35942,1222027,3214034,16228071,4613938,20842009,13903568,4613938,18517506
2022,236948,University of Washington-Seattle Campus,WA,NCAA,NCAA Division I-FBS,Basketball,12422,16556,28978,17,23,187635,3189789,110499,2541470,5731259,10992854,1666078,12658932,10603549,6538965,17142514
2022,240444,University of Wisconsin-Madison,WI,NCAA,NCAA Division I-FBS,Basketball,15600,17947,33547,16,17,166966,2671448,70047,1190800,3862248,18394677,1230869,19625546,11037237,4419467,15456704
2022,240453,University of Wisconsin-Milwaukee,WI,NCAA,NCAA Division I-without football,Basketball,6709,8038,14747,17,14,47668,810354,20082,281147,1091501,3919096,2266845,6185941,3919096,2266845,6185941
2022,240727,University of Wyoming,WY,NCAA,NCAA Division I-FBS,Basketball,3392,3669,7061,15,24,57591,863866,27192,652607,1516473,3506782,2338281,5845063,4097388,2338281,6435669
2022,230728,Utah State University,UT,NCAA,NCAA Division I-FBS,Basketball,7565,8999,16564,15,23,86177,1292656,24638,566674,1859330,5079930,2104357,7184287,5079930,2104357,7184287
2022,230171,Utah Tech University,UT,NCAA,NCAA Division I-FCS,Basketball,2784,4193,6977,16,21,29966,479457,16960,356156,835613,1625080,1199804,2824884,1625080,1199804,2824884
2022,230737,Utah Valley University,UT,NCAA,NCAA Division I-without football,Basketball,9010,8209,17219,17,16,53591,911052,30057,480913,1391965,2301500,1236238,3537738,2301500,1236238,3537738
2022,221999,Vanderbilt University,TN,NCAA,NCAA Division I-FBS,Basketball,3401,3677,7078,16,22,171530,2744473,96093,2114038,4858511,14586531,7915818,22502349,14586531,7915818,22502349
2022,216597,Villanova University,PA,NCAA,NCAA Division I-FCS,Basketball,3099,3653,6752,13,18,274829,3572774,94567,1702206,5274980,18563546,4570612,23134158,12050966,4570612,16621578
2022,234030,Virginia Commonwealth University,VA,NCAA,NCAA Division I-without football,Basketball,6518,11687,18205,15,33,107184,1607763,37696,1243956,2851719,8461356,4394551,12855907,7225180,4394551,11619731
2022,233921,Virginia Polytechnic Institute and State University,VA,NCAA,NCAA Division I-FBS,Basketball,16778,12726,29504,15,13,117386,1760789,98147,1275916,3036705,11754410,1632303,13386713,11676096,4005393,15681489
2022,199847,Wake Forest University,NC,NCAA,NCAA Division I-FBS,Basketball,2410,2978,5388,17,27,148281,2520773,47608,1285413,3806186,11335404,5315051,16650455,11335404,5315051,16650455
2022,236939,Washington State University,WA,NCAA,NCAA Division I-FBS,Basketball,9371,10364,19735,17,22,81064,1378094,36575,804651,2182745,6866552,1068332,7934884,5867954,3921403,9789357
2022,230782,Weber State University,UT,NCAA,NCAA Division I-FCS,Basketball,4372,5746,10118,16,15,39282,628511,24673,370091,998602,2131322,1414720,3546042,2131322,1414720,3546042
2022,238032,West Virginia University,WV,NCAA,NCAA Division I-FBS,Basketball,8514,9029,17543,14,13,194193,2718696,130681,1698859,4417555,8713368,3448193,12161561,11185351,4753640,15938991
2022,200004,Western Carolina University,NC,NCAA,NCAA Division I-FCS,Basketball,3501,4476,7977,16,14,15257,244113,12386,173409,417522,1557165,1120929,2678094,1557165,1120929,2678094
2022,157951,Western Kentucky University,KY,NCAA,NCAA Division I-FBS,Basketball,4199,6756,10955,15,14,61691,925367,29752,416530,1341897,2911549,1461500,4373049,2911549,1461500,4373049
2022,172699,Western Michigan University,MI,NCAA,NCAA Division I-FBS,Basketball,5623,5751,11374,15,14,32860,492904,32334,452676,945580,2141943,1653624,3795567,2141943,1653624,3795567
2022,231624,William & Mary,VA,NCAA,NCAA Division I-FCS,Basketball,2792,3919,6711,15,14,42303,634551,25555,357764,992315,1982420,1240707,3223127,2987990,2188495,5176485
2022,206604,Wright State University-Main Campus,OH,NCAA,NCAA Division I-without football,Basketball,2256,2854,5110,15,16,41759,626379,15572,249156,875535,2908239,1546763,4455002,2908239,1546763,4455002
2022,130794,Yale University,CT,NCAA,NCAA Division I-FCS,Basketball,3218,3370,6588,17,14,24468,415963,24689,345649,761612,2254779,1298673,3553452,1733986,1110798,2844784
2022,206695,Youngstown State University,OH,NCAA,NCAA Division I-FCS,Basketball,3149,3712,6861,14,15,34601,484416,17328,259924,744340,2017741,1294847,3312588,2017741,1294847,3312588
